USN,CollegeName,Result,Score,s1_name,s1_r,s1_f,s1_i,s1_t,s2_name,s2_r,s2_f,s2_i,s2_t,s3_name,s3_r,s3_f,s3_i,s3_t,s4_name,s4_r,s4_f,s4_i,s4_t,s5_name,s5_r,s5_f,s5_i,s5_t
M1610001, College : 4206  -  KLE S SHRI. S M S S B.C.A. COLLEGE  ATHANI,DISTI,73.59,SOFTWARE PRACTICES AND TESTING ,Pass,50,17,67,BUSINESS INTELLIGENCE ,Pass,52,18,70,J2EE ,Pass,32,17,49,J2EE AND SOFTWARE TESTING LABORATORY,Pass,68,18,86,PROJECT AND VIVA VOCE ,Pass,200,52,252
M1610002, College : 4206  -  KLE S SHRI. S M S S B.C.A. COLLEGE  ATHANI,FAIL,69.57,SOFTWARE PRACTICES AND TESTING ,Pass,52,14,66,BUSINESS INTELLIGENCE ,Pass,45,16,61,J2EE ,Fail,19,15,34,J2EE AND SOFTWARE TESTING LABORATORY,Pass,68,16,84,PROJECT AND VIVA VOCE ,Pass,192,50,242
M1610003, College : 4206  -  KLE S SHRI. S M S S B.C.A. COLLEGE  ATHANI,DISTI,72.97,SOFTWARE PRACTICES AND TESTING ,Pass,55,16,71,BUSINESS INTELLIGENCE ,Pass,39,15,54,J2EE ,Pass,49,12,61,J2EE AND SOFTWARE TESTING LABORATORY,Pass,72,19,91,PROJECT AND VIVA VOCE ,Pass,160,45,205
M1610004, College : 4206  -  KLE S SHRI. S M S S B.C.A. COLLEGE  ATHANI,1ST C,66.46,SOFTWARE PRACTICES AND TESTING ,Pass,52,14,66,BUSINESS INTELLIGENCE ,Pass,47,16,63,J2EE ,Pass,32,14,46,J2EE AND SOFTWARE TESTING LABORATORY,Pass,65,15,80,PROJECT AND VIVA VOCE ,Pass,228,50,278
M1610005, College : 4206  -  KLE S SHRI. S M S S B.C.A. COLLEGE  ATHANI,DISTI,74.38,SOFTWARE PRACTICES AND TESTING ,Pass,45,17,62,BUSINESS INTELLIGENCE ,Pass,56,17,73,J2EE ,Pass,40,17,57,J2EE AND SOFTWARE TESTING LABORATORY,Pass,70,18,88,PROJECT AND VIVA VOCE ,Pass,216,55,271
M1610007, College : 4206  -  KLE S SHRI. S M S S B.C.A. COLLEGE  ATHANI,DISTI,87.65,SOFTWARE PRACTICES AND TESTING ,Pass,70,20,90,BUSINESS INTELLIGENCE ,Pass,74,19,93,J2EE ,Pass,51,19,70,J2EE AND SOFTWARE TESTING LABORATORY,Pass,77,19,96,PROJECT AND VIVA VOCE ,Pass,221,55,276
M1610008, College : 4206  -  KLE S SHRI. S M S S B.C.A. COLLEGE  ATHANI,N.C.L,--   ,SOFTWARE PRACTICES AND TESTING ,Pass,51,15,66,BUSINESS INTELLIGENCE ,Pass,45,17,62,J2EE ,Pass,35,14,49,J2EE AND SOFTWARE TESTING LABORATORY,Pass,63,16,79,PROJECT AND VIVA VOCE ,Pass,203,51,254
M1610009, College : 4206  -  KLE S SHRI. S M S S B.C.A. COLLEGE  ATHANI,FAIL,70.43,SOFTWARE PRACTICES AND TESTING ,Pass,48,16,64,BUSINESS INTELLIGENCE ,Pass,43,17,60,J2EE ,Fail,22,15,37,J2EE AND SOFTWARE TESTING LABORATORY,Pass,63,17,80,PROJECT AND VIVA VOCE ,Pass,200,52,252
M1610010, College : 4206  -  KLE S SHRI. S M S S B.C.A. COLLEGE  ATHANI,DISTI,79.7,SOFTWARE PRACTICES AND TESTING ,Pass,62,16,78,BUSINESS INTELLIGENCE ,Pass,53,16,69,J2EE ,Pass,56,15,71,J2EE AND SOFTWARE TESTING LABORATORY,Pass,75,17,92,PROJECT AND VIVA VOCE ,Pass,200,54,254
M1610011, College : 4206  -  KLE S SHRI. S M S S B.C.A. COLLEGE  ATHANI,1ST C,68.11,SOFTWARE PRACTICES AND TESTING ,Pass,63,17,80,BUSINESS INTELLIGENCE ,Pass,49,20,69,J2EE ,Pass,47,17,64,J2EE AND SOFTWARE TESTING LABORATORY,Pass,65,17,82,PROJECT AND VIVA VOCE ,Pass,209,53,262
M1610012, College : 4206  -  KLE S SHRI. S M S S B.C.A. COLLEGE  ATHANI,DISTI,82.7,SOFTWARE PRACTICES AND TESTING ,Pass,60,18,78,BUSINESS INTELLIGENCE ,Pass,54,18,72,J2EE ,Pass,57,19,76,J2EE AND SOFTWARE TESTING LABORATORY,Pass,78,18,96,PROJECT AND VIVA VOCE ,Pass,210,55,265
M1610013, College : 4206  -  KLE S SHRI. S M S S B.C.A. COLLEGE  ATHANI,DISTI,83.24,SOFTWARE PRACTICES AND TESTING ,Pass,62,18,80,BUSINESS INTELLIGENCE ,Pass,54,18,72,J2EE ,Pass,58,18,76,J2EE AND SOFTWARE TESTING LABORATORY,Pass,67,18,85,PROJECT AND VIVA VOCE ,Pass,210,54,264
M1610014, College : 4206  -  KLE S SHRI. S M S S B.C.A. COLLEGE  ATHANI,DISTI,82.73,SOFTWARE PRACTICES AND TESTING ,Pass,60,18,78,BUSINESS INTELLIGENCE ,Pass,59,18,77,J2EE ,Pass,64,18,82,J2EE AND SOFTWARE TESTING LABORATORY,Pass,75,18,93,PROJECT AND VIVA VOCE ,Pass,213,55,268
M1610015, College : 4206  -  KLE S SHRI. S M S S B.C.A. COLLEGE  ATHANI,N.C.L,--   ,SOFTWARE PRACTICES AND TESTING ,Pass,37,15,52,BUSINESS INTELLIGENCE ,Pass,44,17,61,J2EE ,Pass,41,15,56,J2EE AND SOFTWARE TESTING LABORATORY,Pass,57,15,72,PROJECT AND VIVA VOCE ,Pass,180,50,230
M1610016, College : 4206  -  KLE S SHRI. S M S S B.C.A. COLLEGE  ATHANI,N.C.L,--   ,SOFTWARE PRACTICES AND TESTING ,Pass,50,18,68,BUSINESS INTELLIGENCE ,Pass,48,18,66,J2EE ,Pass,44,18,62,J2EE AND SOFTWARE TESTING LABORATORY,Pass,76,18,94,PROJECT AND VIVA VOCE ,Pass,210,54,264
M1610017, College : 4206  -  KLE S SHRI. S M S S B.C.A. COLLEGE  ATHANI,DISTI,82.65,SOFTWARE PRACTICES AND TESTING ,Pass,64,18,82,BUSINESS INTELLIGENCE ,Pass,60,19,79,J2EE ,Pass,63,18,81,J2EE AND SOFTWARE TESTING LABORATORY,Pass,75,18,93,PROJECT AND VIVA VOCE ,Pass,209,54,263
M1610018, College : 4206  -  KLE S SHRI. S M S S B.C.A. COLLEGE  ATHANI,N.C.L,--   ,SOFTWARE PRACTICES AND TESTING ,Pass,32,15,47,BUSINESS INTELLIGENCE ,Pass,35,17,52,J2EE ,Pass,37,16,53,J2EE AND SOFTWARE TESTING LABORATORY,Pass,35,17,52,PROJECT AND VIVA VOCE ,Pass,193,50,243
M1610019, College : 4206  -  KLE S SHRI. S M S S B.C.A. COLLEGE  ATHANI,DISTI,74.27,SOFTWARE PRACTICES AND TESTING ,Pass,39,18,57,BUSINESS INTELLIGENCE ,Pass,49,19,68,J2EE ,Pass,32,18,50,J2EE AND SOFTWARE TESTING LABORATORY,Pass,75,18,93,PROJECT AND VIVA VOCE ,Pass,221,56,277
M1610020, College : 4206  -  KLE S SHRI. S M S S B.C.A. COLLEGE  ATHANI,FAIL,76,SOFTWARE PRACTICES AND TESTING ,Pass,61,18,79,BUSINESS INTELLIGENCE ,Pass,62,19,81,J2EE ,Fail,20,18,38,J2EE AND SOFTWARE TESTING LABORATORY,Pass,58,18,76,PROJECT AND VIVA VOCE ,Pass,204,54,258
M1610021, College : 4206  -  KLE S SHRI. S M S S B.C.A. COLLEGE  ATHANI,1ST C,69.73,SOFTWARE PRACTICES AND TESTING ,Pass,51,18,69,BUSINESS INTELLIGENCE ,Pass,60,17,77,J2EE ,Pass,36,17,53,J2EE AND SOFTWARE TESTING LABORATORY,Pass,77,19,96,PROJECT AND VIVA VOCE ,Pass,204,55,259
M1610022, College : 4206  -  KLE S SHRI. S M S S B.C.A. COLLEGE  ATHANI,1ST C,68,SOFTWARE PRACTICES AND TESTING ,Pass,34,16,50,BUSINESS INTELLIGENCE ,Pass,42,16,58,J2EE ,Pass,32,17,49,J2EE AND SOFTWARE TESTING LABORATORY,Pass,73,18,91,PROJECT AND VIVA VOCE ,Pass,200,56,256
M1610023, College : 4206  -  KLE S SHRI. S M S S B.C.A. COLLEGE  ATHANI,1ST C,64.27,SOFTWARE PRACTICES AND TESTING ,Pass,48,15,63,BUSINESS INTELLIGENCE ,Pass,60,17,77,J2EE ,Pass,32,16,48,J2EE AND SOFTWARE TESTING LABORATORY,Pass,63,17,80,PROJECT AND VIVA VOCE ,Pass,190,53,243
M1610024, College : 4206  -  KLE S SHRI. S M S S B.C.A. COLLEGE  ATHANI,DISTI,79.76,SOFTWARE PRACTICES AND TESTING ,Pass,60,19,79,BUSINESS INTELLIGENCE ,Pass,61,20,81,J2EE ,Pass,41,19,60,J2EE AND SOFTWARE TESTING LABORATORY,Pass,78,19,97,PROJECT AND VIVA VOCE ,Pass,205,56,261
M1610026, College : 4206  -  KLE S SHRI. S M S S B.C.A. COLLEGE  ATHANI,N.C.L,--   ,SOFTWARE PRACTICES AND TESTING ,Pass,46,15,61,BUSINESS INTELLIGENCE ,Pass,45,16,61,J2EE ,Pass,40,14,54,J2EE AND SOFTWARE TESTING LABORATORY,Pass,70,16,86,PROJECT AND VIVA VOCE ,Pass,192,51,243
M1610027, College : 4206  -  KLE S SHRI. S M S S B.C.A. COLLEGE  ATHANI,N.C.L,--   ,SOFTWARE PRACTICES AND TESTING ,Pass,43,15,58,BUSINESS INTELLIGENCE ,Pass,33,16,49,J2EE ,Pass,32,14,46,J2EE AND SOFTWARE TESTING LABORATORY,Pass,43,15,58,PROJECT AND VIVA VOCE ,Pass,216,50,266
M1610028, College : 4206  -  KLE S SHRI. S M S S B.C.A. COLLEGE  ATHANI,DISTI,84.89,SOFTWARE PRACTICES AND TESTING ,Pass,64,18,82,BUSINESS INTELLIGENCE ,Pass,55,20,75,J2EE ,Pass,54,18,72,J2EE AND SOFTWARE TESTING LABORATORY,Pass,78,18,96,PROJECT AND VIVA VOCE ,Pass,212,56,268
M1610029, College : 4206  -  KLE S SHRI. S M S S B.C.A. COLLEGE  ATHANI,DISTI,80.46,SOFTWARE PRACTICES AND TESTING ,Pass,45,18,63,BUSINESS INTELLIGENCE ,Pass,58,18,76,J2EE ,Pass,49,18,67,J2EE AND SOFTWARE TESTING LABORATORY,Pass,72,18,90,PROJECT AND VIVA VOCE ,Pass,211,54,265
M1610030, College : 4206  -  KLE S SHRI. S M S S B.C.A. COLLEGE  ATHANI,DISTI,85.97,SOFTWARE PRACTICES AND TESTING ,Pass,65,18,83,BUSINESS INTELLIGENCE ,Pass,71,18,89,J2EE ,Pass,63,18,81,J2EE AND SOFTWARE TESTING LABORATORY,Pass,69,18,87,PROJECT AND VIVA VOCE ,Pass,214,55,269
M1610031, College : 4206  -  KLE S SHRI. S M S S B.C.A. COLLEGE  ATHANI,DISTI,79.32,SOFTWARE PRACTICES AND TESTING ,Pass,57,18,75,BUSINESS INTELLIGENCE ,Pass,61,17,78,J2EE ,Pass,52,18,70,J2EE AND SOFTWARE TESTING LABORATORY,Pass,74,18,92,PROJECT AND VIVA VOCE ,Pass,201,54,255
M1610032, College : 4206  -  KLE S SHRI. S M S S B.C.A. COLLEGE  ATHANI,DISTI,75.65,SOFTWARE PRACTICES AND TESTING ,Pass,46,18,64,BUSINESS INTELLIGENCE ,Pass,59,17,76,J2EE ,Pass,56,17,73,J2EE AND SOFTWARE TESTING LABORATORY,Pass,67,19,86,PROJECT AND VIVA VOCE ,Pass,203,56,259
M1610033, College : 4206  -  KLE S SHRI. S M S S B.C.A. COLLEGE  ATHANI,DISTI,79.41,SOFTWARE PRACTICES AND TESTING ,Pass,58,18,76,BUSINESS INTELLIGENCE ,Pass,71,16,87,J2EE ,Pass,66,17,83,J2EE AND SOFTWARE TESTING LABORATORY,Pass,72,18,90,PROJECT AND VIVA VOCE ,Pass,200,55,255
M1610034, College : 4206  -  KLE S SHRI. S M S S B.C.A. COLLEGE  ATHANI,1ST C,65.86,SOFTWARE PRACTICES AND TESTING ,Pass,36,15,51,BUSINESS INTELLIGENCE ,Pass,45,17,62,J2EE ,Pass,46,15,61,J2EE AND SOFTWARE TESTING LABORATORY,Pass,68,16,84,PROJECT AND VIVA VOCE ,Pass,193,51,244
M1610036, College : 4206  -  KLE S SHRI. S M S S B.C.A. COLLEGE  ATHANI,DISTI,87.65,SOFTWARE PRACTICES AND TESTING ,Pass,64,18,82,BUSINESS INTELLIGENCE ,Pass,75,19,94,J2EE ,Pass,57,18,75,J2EE AND SOFTWARE TESTING LABORATORY,Pass,77,18,95,PROJECT AND VIVA VOCE ,Pass,223,57,280
M1610037, College : 4206  -  KLE S SHRI. S M S S B.C.A. COLLEGE  ATHANI,1ST C,67.78,SOFTWARE PRACTICES AND TESTING ,Pass,45,17,62,BUSINESS INTELLIGENCE ,Pass,60,19,79,J2EE ,Pass,38,16,54,J2EE AND SOFTWARE TESTING LABORATORY,Pass,65,17,82,PROJECT AND VIVA VOCE ,Pass,193,50,243
M1610038, College : 4206  -  KLE S SHRI. S M S S B.C.A. COLLEGE  ATHANI,DISTI,79.76,SOFTWARE PRACTICES AND TESTING ,Pass,57,18,75,BUSINESS INTELLIGENCE ,Pass,70,19,89,J2EE ,Pass,50,18,68,J2EE AND SOFTWARE TESTING LABORATORY,Pass,71,18,89,PROJECT AND VIVA VOCE ,Pass,201,54,255
M1610039, College : 4206  -  KLE S SHRI. S M S S B.C.A. COLLEGE  ATHANI,1ST C,68.05,SOFTWARE PRACTICES AND TESTING ,Pass,45,15,60,BUSINESS INTELLIGENCE ,Pass,51,16,67,J2EE ,Pass,46,15,61,J2EE AND SOFTWARE TESTING LABORATORY,Pass,71,17,88,PROJECT AND VIVA VOCE ,Pass,211,53,264
M1610040, College : 4206  -  KLE S SHRI. S M S S B.C.A. COLLEGE  ATHANI,1ST C,68.35,SOFTWARE PRACTICES AND TESTING ,Pass,44,15,59,BUSINESS INTELLIGENCE ,Pass,56,16,72,J2EE ,Pass,40,15,55,J2EE AND SOFTWARE TESTING LABORATORY,Pass,68,16,84,PROJECT AND VIVA VOCE ,Pass,191,54,245
M1610041, College : 4206  -  KLE S SHRI. S M S S B.C.A. COLLEGE  ATHANI,1ST C,66.54,SOFTWARE PRACTICES AND TESTING ,Pass,38,18,56,BUSINESS INTELLIGENCE ,Pass,44,18,62,J2EE ,Pass,33,16,49,J2EE AND SOFTWARE TESTING LABORATORY,Pass,69,18,87,PROJECT AND VIVA VOCE ,Pass,209,56,265
M1610042, College : 4206  -  KLE S SHRI. S M S S B.C.A. COLLEGE  ATHANI,DISTI,84.3,SOFTWARE PRACTICES AND TESTING ,Pass,55,18,73,BUSINESS INTELLIGENCE ,Pass,62,19,81,J2EE ,Pass,49,19,68,J2EE AND SOFTWARE TESTING LABORATORY,Pass,78,19,97,PROJECT AND VIVA VOCE ,Pass,213,57,270
M1610043, College : 4206  -  KLE S SHRI. S M S S B.C.A. COLLEGE  ATHANI,DISTI,71.86,SOFTWARE PRACTICES AND TESTING ,Pass,52,17,69,BUSINESS INTELLIGENCE ,Pass,60,19,79,J2EE ,Pass,34,17,51,J2EE AND SOFTWARE TESTING LABORATORY,Pass,67,17,84,PROJECT AND VIVA VOCE ,Pass,203,54,257
M1610044, College : 4206  -  KLE S SHRI. S M S S B.C.A. COLLEGE  ATHANI,FAIL,72.71,SOFTWARE PRACTICES AND TESTING ,Pass,45,18,63,BUSINESS INTELLIGENCE ,Pass,37,18,55,J2EE ,Fail,23,17,40,J2EE AND SOFTWARE TESTING LABORATORY,Pass,75,19,94,PROJECT AND VIVA VOCE ,Pass,205,52,257
M1610045, College : 4206  -  KLE S SHRI. S M S S B.C.A. COLLEGE  ATHANI,DISTI,82.32,SOFTWARE PRACTICES AND TESTING ,Pass,54,18,72,BUSINESS INTELLIGENCE ,Pass,65,19,84,J2EE ,Pass,39,18,57,J2EE AND SOFTWARE TESTING LABORATORY,Pass,77,18,95,PROJECT AND VIVA VOCE ,Pass,228,53,281
M1610046, College : 4206  -  KLE S SHRI. S M S S B.C.A. COLLEGE  ATHANI,FAIL,78,SOFTWARE PRACTICES AND TESTING ,Pass,53,17,70,BUSINESS INTELLIGENCE ,Pass,57,18,75,J2EE ,Fail,23,17,40,J2EE AND SOFTWARE TESTING LABORATORY,Pass,78,18,96,PROJECT AND VIVA VOCE ,Pass,212,53,265
M1610047, College : 4206  -  KLE S SHRI. S M S S B.C.A. COLLEGE  ATHANI,FAIL,67.43,SOFTWARE PRACTICES AND TESTING ,Pass,32,17,49,BUSINESS INTELLIGENCE ,Pass,33,17,50,J2EE ,Fail,22,17,39,J2EE AND SOFTWARE TESTING LABORATORY,Pass,65,17,82,PROJECT AND VIVA VOCE ,Pass,201,51,252
M1610048, College : 4206  -  KLE S SHRI. S M S S B.C.A. COLLEGE  ATHANI,1ST C,66.22,SOFTWARE PRACTICES AND TESTING ,Pass,40,17,57,BUSINESS INTELLIGENCE ,Pass,45,18,63,J2EE ,Pass,32,17,49,J2EE AND SOFTWARE TESTING LABORATORY,Pass,71,18,89,PROJECT AND VIVA VOCE ,Pass,193,53,246
M1610049, College : 4206  -  KLE S SHRI. S M S S B.C.A. COLLEGE  ATHANI,DISTI,86.11,SOFTWARE PRACTICES AND TESTING ,Pass,56,18,74,BUSINESS INTELLIGENCE ,Pass,52,18,70,J2EE ,Pass,49,18,67,J2EE AND SOFTWARE TESTING LABORATORY,Pass,78,18,96,PROJECT AND VIVA VOCE ,Pass,214,56,270
M1610050, College : 4206  -  KLE S SHRI. S M S S B.C.A. COLLEGE  ATHANI,1ST C,69.35,SOFTWARE PRACTICES AND TESTING ,Pass,46,17,63,BUSINESS INTELLIGENCE ,Pass,47,17,64,J2EE ,Pass,38,17,55,J2EE AND SOFTWARE TESTING LABORATORY,Pass,60,17,77,PROJECT AND VIVA VOCE ,Pass,201,52,253
M1610051, College : 4206  -  KLE S SHRI. S M S S B.C.A. COLLEGE  ATHANI,DISTI,76.35,SOFTWARE PRACTICES AND TESTING ,Pass,47,18,65,BUSINESS INTELLIGENCE ,Pass,45,20,65,J2EE ,Pass,42,18,60,J2EE AND SOFTWARE TESTING LABORATORY,Pass,75,19,94,PROJECT AND VIVA VOCE ,Pass,215,54,269
M1610201, College : 4218  -  SKES S G S SCIENCE COLLEGE  BELAGAVI,DISTI,78.95,SOFTWARE PRACTICES AND TESTING ,Pass,62,20,82,BUSINESS INTELLIGENCE ,Pass,61,20,81,J2EE ,Pass,63,17,80,J2EE AND SOFTWARE TESTING LABORATORY,Pass,69,18,87,PROJECT AND VIVA VOCE ,Pass,230,58,288
M1610202, College : 4218  -  SKES S G S SCIENCE COLLEGE  BELAGAVI,1ST C,67.62,SOFTWARE PRACTICES AND TESTING ,Pass,46,8,54,BUSINESS INTELLIGENCE ,Pass,53,8,61,J2EE ,Pass,51,8,59,J2EE AND SOFTWARE TESTING LABORATORY,Pass,76,8,84,PROJECT AND VIVA VOCE ,Pass,228,48,276
M1610203, College : 4218  -  SKES S G S SCIENCE COLLEGE  BELAGAVI,DISTI,72.97,SOFTWARE PRACTICES AND TESTING ,Pass,42,17,59,BUSINESS INTELLIGENCE ,Pass,39,10,49,J2EE ,Pass,41,11,52,J2EE AND SOFTWARE TESTING LABORATORY,Pass,48,15,63,PROJECT AND VIVA VOCE ,Pass,232,53,285
M1610204, College : 4218  -  SKES S G S SCIENCE COLLEGE  BELAGAVI,DISTI,91.84,SOFTWARE PRACTICES AND TESTING ,Pass,67,20,87,BUSINESS INTELLIGENCE ,Pass,74,20,94,J2EE ,Pass,63,20,83,J2EE AND SOFTWARE TESTING LABORATORY,Pass,80,20,100,PROJECT AND VIVA VOCE ,Pass,232,60,292
M1610205, College : 4218  -  SKES S G S SCIENCE COLLEGE  BELAGAVI,1ST C,67.35,SOFTWARE PRACTICES AND TESTING ,Pass,73,8,81,BUSINESS INTELLIGENCE ,Pass,70,9,79,J2EE ,Pass,61,12,73,J2EE AND SOFTWARE TESTING LABORATORY,Pass,76,11,87,PROJECT AND VIVA VOCE ,Pass,229,53,282
M1610206, College : 4218  -  SKES S G S SCIENCE COLLEGE  BELAGAVI,N.C.L,--   ,SOFTWARE PRACTICES AND TESTING ,Pass,45,8,53,BUSINESS INTELLIGENCE ,Pass,47,8,55,J2EE ,Pass,46,9,55,J2EE AND SOFTWARE TESTING LABORATORY,Pass,63,8,71,PROJECT AND VIVA VOCE ,Pass,210,48,258
M1610207, College : 4218  -  SKES S G S SCIENCE COLLEGE  BELAGAVI,N.C.L,--   ,SOFTWARE PRACTICES AND TESTING ,Pass,40,14,54,BUSINESS INTELLIGENCE ,Pass,45,14,59,J2EE ,Pass,40,14,54,J2EE AND SOFTWARE TESTING LABORATORY,Pass,49,9,58,PROJECT AND VIVA VOCE ,Pass,226,53,279
M1610208, College : 4218  -  SKES S G S SCIENCE COLLEGE  BELAGAVI,1ST C,65.92,SOFTWARE PRACTICES AND TESTING ,Pass,52,13,65,BUSINESS INTELLIGENCE ,Pass,51,10,61,J2EE ,Pass,48,8,56,J2EE AND SOFTWARE TESTING LABORATORY,Pass,43,16,59,PROJECT AND VIVA VOCE ,Pass,210,58,268
M1610209, College : 4218  -  SKES S G S SCIENCE COLLEGE  BELAGAVI,FAIL,25.14,SOFTWARE PRACTICES AND TESTING ,Fail,Ab.,3,3,BUSINESS INTELLIGENCE ,Fail,32,3,35,J2EE ,Fail,Ab.,3,3,J2EE AND SOFTWARE TESTING LABORATORY,Fail,Ab.,3,3,PROJECT AND VIVA VOCE ,Pass,120,12,132
M1610211, College : 4218  -  SKES S G S SCIENCE COLLEGE  BELAGAVI,N.C.L,--   ,SOFTWARE PRACTICES AND TESTING ,Pass,58,13,71,BUSINESS INTELLIGENCE ,Pass,52,16,68,J2EE ,Pass,34,14,48,J2EE AND SOFTWARE TESTING LABORATORY,Pass,69,14,83,PROJECT AND VIVA VOCE ,Pass,205,53,258
M1610212, College : 4218  -  SKES S G S SCIENCE COLLEGE  BELAGAVI,N.C.L,--   ,SOFTWARE PRACTICES AND TESTING ,Pass,55,9,64,BUSINESS INTELLIGENCE ,Pass,57,9,66,J2EE ,Pass,41,10,51,J2EE AND SOFTWARE TESTING LABORATORY,Pass,50,15,65,PROJECT AND VIVA VOCE ,Pass,205,48,253
M1610213, College : 4218  -  SKES S G S SCIENCE COLLEGE  BELAGAVI,DISTI,89.16,SOFTWARE PRACTICES AND TESTING ,Pass,72,15,87,BUSINESS INTELLIGENCE ,Pass,77,19,96,J2EE ,Pass,66,16,82,J2EE AND SOFTWARE TESTING LABORATORY,Pass,78,20,98,PROJECT AND VIVA VOCE ,Pass,230,58,288
M1610214, College : 4218  -  SKES S G S SCIENCE COLLEGE  BELAGAVI,N.C.L,--   ,SOFTWARE PRACTICES AND TESTING ,Pass,60,9,69,BUSINESS INTELLIGENCE ,Pass,60,12,72,J2EE ,Pass,60,10,70,J2EE AND SOFTWARE TESTING LABORATORY,Pass,77,19,96,PROJECT AND VIVA VOCE ,Pass,225,53,278
M1610215, College : 4218  -  SKES S G S SCIENCE COLLEGE  BELAGAVI,DISTI,72.35,SOFTWARE PRACTICES AND TESTING ,Pass,43,15,58,BUSINESS INTELLIGENCE ,Pass,50,16,66,J2EE ,Pass,37,13,50,J2EE AND SOFTWARE TESTING LABORATORY,Pass,62,20,82,PROJECT AND VIVA VOCE ,Pass,218,58,276
M1610216, College : 4218  -  SKES S G S SCIENCE COLLEGE  BELAGAVI,1ST C,67.76,SOFTWARE PRACTICES AND TESTING ,Pass,41,15,56,BUSINESS INTELLIGENCE ,Pass,34,11,45,J2EE ,Pass,32,17,49,J2EE AND SOFTWARE TESTING LABORATORY,Pass,55,20,75,PROJECT AND VIVA VOCE ,Pass,232,53,285
M1610217, College : 4218  -  SKES S G S SCIENCE COLLEGE  BELAGAVI,DISTI,81.59,SOFTWARE PRACTICES AND TESTING ,Pass,55,14,69,BUSINESS INTELLIGENCE ,Pass,49,12,61,J2EE ,Pass,45,13,58,J2EE AND SOFTWARE TESTING LABORATORY,Pass,53,20,73,PROJECT AND VIVA VOCE ,Pass,228,48,276
M1610218, College : 4218  -  SKES S G S SCIENCE COLLEGE  BELAGAVI,DISTI,80.51,SOFTWARE PRACTICES AND TESTING ,Pass,65,14,79,BUSINESS INTELLIGENCE ,Pass,68,18,86,J2EE ,Pass,55,18,73,J2EE AND SOFTWARE TESTING LABORATORY,Pass,59,20,79,PROJECT AND VIVA VOCE ,Pass,230,58,288
M1610219, College : 4218  -  SKES S G S SCIENCE COLLEGE  BELAGAVI,DISTI,84.97,SOFTWARE PRACTICES AND TESTING ,Pass,68,15,83,BUSINESS INTELLIGENCE ,Pass,76,16,92,J2EE ,Pass,62,13,75,J2EE AND SOFTWARE TESTING LABORATORY,Pass,69,20,89,PROJECT AND VIVA VOCE ,Pass,196,48,244
M1610220, College : 4218  -  SKES S G S SCIENCE COLLEGE  BELAGAVI,FAIL,52.71,SOFTWARE PRACTICES AND TESTING ,Pass,43,10,53,BUSINESS INTELLIGENCE ,Pass,35,8,43,J2EE ,Fail,14,8,22,J2EE AND SOFTWARE TESTING LABORATORY,Pass,45,8,53,PROJECT AND VIVA VOCE ,Pass,150,48,198
M1610221, College : 4218  -  SKES S G S SCIENCE COLLEGE  BELAGAVI,N.C.L,--   ,SOFTWARE PRACTICES AND TESTING ,Pass,46,18,64,BUSINESS INTELLIGENCE ,Pass,54,18,72,J2EE ,Pass,37,18,55,J2EE AND SOFTWARE TESTING LABORATORY,Pass,75,18,93,PROJECT AND VIVA VOCE ,Pass,225,55,280
M1610222, College : 4218  -  SKES S G S SCIENCE COLLEGE  BELAGAVI,1ST C,68.86,SOFTWARE PRACTICES AND TESTING ,Pass,70,9,79,BUSINESS INTELLIGENCE ,Pass,61,16,77,J2EE ,Pass,41,16,57,J2EE AND SOFTWARE TESTING LABORATORY,Pass,74,20,94,PROJECT AND VIVA VOCE ,Pass,140,33,173
M1610223, College : 4218  -  SKES S G S SCIENCE COLLEGE  BELAGAVI,DISTI,73.41,SOFTWARE PRACTICES AND TESTING ,Pass,60,12,72,BUSINESS INTELLIGENCE ,Pass,66,14,80,J2EE ,Pass,53,15,68,J2EE AND SOFTWARE TESTING LABORATORY,Pass,65,15,80,PROJECT AND VIVA VOCE ,Pass,229,53,282
M1610224, College : 4218  -  SKES S G S SCIENCE COLLEGE  BELAGAVI,1ST C,68.03,SOFTWARE PRACTICES AND TESTING ,Pass,55,10,65,BUSINESS INTELLIGENCE ,Pass,51,8,59,J2EE ,Pass,36,9,45,J2EE AND SOFTWARE TESTING LABORATORY,Pass,65,8,73,PROJECT AND VIVA VOCE ,Pass,140,33,173
M1610225, College : 4218  -  SKES S G S SCIENCE COLLEGE  BELAGAVI,DISTI,79.57,SOFTWARE PRACTICES AND TESTING ,Pass,65,12,77,BUSINESS INTELLIGENCE ,Pass,71,13,84,J2EE ,Pass,54,13,67,J2EE AND SOFTWARE TESTING LABORATORY,Pass,72,12,84,PROJECT AND VIVA VOCE ,Pass,230,53,283
M1610226, College : 4218  -  SKES S G S SCIENCE COLLEGE  BELAGAVI,DISTI,89.14,SOFTWARE PRACTICES AND TESTING ,Pass,70,19,89,BUSINESS INTELLIGENCE ,Pass,58,19,77,J2EE ,Pass,75,19,94,J2EE AND SOFTWARE TESTING LABORATORY,Pass,74,20,94,PROJECT AND VIVA VOCE ,Pass,230,58,288
M1610227, College : 4218  -  SKES S G S SCIENCE COLLEGE  BELAGAVI,DISTI,95.32,SOFTWARE PRACTICES AND TESTING ,Pass,78,20,98,BUSINESS INTELLIGENCE ,Pass,79,20,99,J2EE ,Pass,79,20,99,J2EE AND SOFTWARE TESTING LABORATORY,Pass,80,20,100,PROJECT AND VIVA VOCE ,Pass,239,60,299
M1610228, College : 4218  -  SKES S G S SCIENCE COLLEGE  BELAGAVI,DISTI,81.54,SOFTWARE PRACTICES AND TESTING ,Pass,56,19,75,BUSINESS INTELLIGENCE ,Pass,64,20,84,J2EE ,Pass,63,16,79,J2EE AND SOFTWARE TESTING LABORATORY,Pass,77,20,97,PROJECT AND VIVA VOCE ,Pass,231,53,284
M1610229, College : 4218  -  SKES S G S SCIENCE COLLEGE  BELAGAVI,DISTI,70,SOFTWARE PRACTICES AND TESTING ,Pass,64,12,76,BUSINESS INTELLIGENCE ,Pass,59,13,72,J2EE ,Pass,56,13,69,J2EE AND SOFTWARE TESTING LABORATORY,Pass,65,14,79,PROJECT AND VIVA VOCE ,Pass,227,53,280
M1610230, College : 4218  -  SKES S G S SCIENCE COLLEGE  BELAGAVI,DISTI,85.86,SOFTWARE PRACTICES AND TESTING ,Pass,66,17,83,BUSINESS INTELLIGENCE ,Pass,62,20,82,J2EE ,Pass,56,15,71,J2EE AND SOFTWARE TESTING LABORATORY,Pass,76,20,96,PROJECT AND VIVA VOCE ,Pass,228,58,286
M1610231, College : 4218  -  SKES S G S SCIENCE COLLEGE  BELAGAVI,N.C.L,--   ,SOFTWARE PRACTICES AND TESTING ,Pass,36,8,44,BUSINESS INTELLIGENCE ,Pass,42,8,50,J2EE ,Pass,32,8,40,J2EE AND SOFTWARE TESTING LABORATORY,Pass,36,8,44,PROJECT AND VIVA VOCE ,Pass,150,38,188
M1610232, College : 4218  -  SKES S G S SCIENCE COLLEGE  BELAGAVI,DISTI,70.89,SOFTWARE PRACTICES AND TESTING ,Pass,51,13,64,BUSINESS INTELLIGENCE ,Pass,46,13,59,J2EE ,Pass,48,15,63,J2EE AND SOFTWARE TESTING LABORATORY,Pass,65,20,85,PROJECT AND VIVA VOCE ,Pass,230,58,288
M1610233, College : 4218  -  SKES S G S SCIENCE COLLEGE  BELAGAVI,N.C.L,--   ,SOFTWARE PRACTICES AND TESTING ,Pass,48,10,58,BUSINESS INTELLIGENCE ,Pass,34,13,47,J2EE ,Pass,38,12,50,J2EE AND SOFTWARE TESTING LABORATORY,Pass,37,19,56,PROJECT AND VIVA VOCE ,Pass,196,43,239
M1610235, College : 4218  -  SKES S G S SCIENCE COLLEGE  BELAGAVI,DISTI,85.27,SOFTWARE PRACTICES AND TESTING ,Pass,75,20,95,BUSINESS INTELLIGENCE ,Pass,65,20,85,J2EE ,Pass,73,19,92,J2EE AND SOFTWARE TESTING LABORATORY,Pass,66,20,86,PROJECT AND VIVA VOCE ,Pass,215,58,273
M1610236, College : 4218  -  SKES S G S SCIENCE COLLEGE  BELAGAVI,DISTI,84.59,SOFTWARE PRACTICES AND TESTING ,Pass,58,13,71,BUSINESS INTELLIGENCE ,Pass,70,17,87,J2EE ,Pass,48,18,66,J2EE AND SOFTWARE TESTING LABORATORY,Pass,73,20,93,PROJECT AND VIVA VOCE ,Pass,237,53,290
M1610237, College : 4218  -  SKES S G S SCIENCE COLLEGE  BELAGAVI,DISTI,80.62,SOFTWARE PRACTICES AND TESTING ,Pass,53,11,64,BUSINESS INTELLIGENCE ,Pass,39,15,54,J2EE ,Pass,61,16,77,J2EE AND SOFTWARE TESTING LABORATORY,Pass,76,20,96,PROJECT AND VIVA VOCE ,Pass,231,58,289
M1610238, College : 4218  -  SKES S G S SCIENCE COLLEGE  BELAGAVI,N.C.L,--   ,SOFTWARE PRACTICES AND TESTING ,Pass,65,14,79,BUSINESS INTELLIGENCE ,Pass,63,16,79,J2EE ,Pass,53,13,66,J2EE AND SOFTWARE TESTING LABORATORY,Pass,42,14,56,PROJECT AND VIVA VOCE ,Pass,230,53,283
M1610239, College : 4218  -  SKES S G S SCIENCE COLLEGE  BELAGAVI,DISTI,85.97,SOFTWARE PRACTICES AND TESTING ,Pass,67,19,86,BUSINESS INTELLIGENCE ,Pass,65,20,85,J2EE ,Pass,60,19,79,J2EE AND SOFTWARE TESTING LABORATORY,Pass,79,20,99,PROJECT AND VIVA VOCE ,Pass,230,58,288
M1610240, College : 4218  -  SKES S G S SCIENCE COLLEGE  BELAGAVI,DISTI,90.46,SOFTWARE PRACTICES AND TESTING ,Pass,73,19,92,BUSINESS INTELLIGENCE ,Pass,75,20,95,J2EE ,Pass,64,17,81,J2EE AND SOFTWARE TESTING LABORATORY,Pass,64,20,84,PROJECT AND VIVA VOCE ,Pass,230,58,288
M1610241, College : 4218  -  SKES S G S SCIENCE COLLEGE  BELAGAVI,DISTI,77.57,SOFTWARE PRACTICES AND TESTING ,Pass,67,16,83,BUSINESS INTELLIGENCE ,Pass,55,19,74,J2EE ,Pass,48,15,63,J2EE AND SOFTWARE TESTING LABORATORY,Pass,67,20,87,PROJECT AND VIVA VOCE ,Pass,225,58,283
M1610242, College : 4218  -  SKES S G S SCIENCE COLLEGE  BELAGAVI,DISTI,84.41,SOFTWARE PRACTICES AND TESTING ,Pass,60,18,78,BUSINESS INTELLIGENCE ,Pass,62,19,81,J2EE ,Pass,58,15,73,J2EE AND SOFTWARE TESTING LABORATORY,Pass,74,20,94,PROJECT AND VIVA VOCE ,Pass,229,58,287
M1610243, College : 4218  -  SKES S G S SCIENCE COLLEGE  BELAGAVI,DISTI,89.49,SOFTWARE PRACTICES AND TESTING ,Pass,66,18,84,BUSINESS INTELLIGENCE ,Pass,76,19,95,J2EE ,Pass,59,18,77,J2EE AND SOFTWARE TESTING LABORATORY,Pass,78,20,98,PROJECT AND VIVA VOCE ,Pass,230,58,288
M1610244, College : 4218  -  SKES S G S SCIENCE COLLEGE  BELAGAVI,N.C.L,--   ,SOFTWARE PRACTICES AND TESTING ,Pass,50,10,60,BUSINESS INTELLIGENCE ,Pass,41,12,53,J2EE ,Pass,46,11,57,J2EE AND SOFTWARE TESTING LABORATORY,Pass,70,20,90,PROJECT AND VIVA VOCE ,Pass,225,43,268
M1610245, College : 4218  -  SKES S G S SCIENCE COLLEGE  BELAGAVI,DISTI,85.27,SOFTWARE PRACTICES AND TESTING ,Pass,75,15,90,BUSINESS INTELLIGENCE ,Pass,50,20,70,J2EE ,Pass,69,20,89,J2EE AND SOFTWARE TESTING LABORATORY,Pass,79,20,99,PROJECT AND VIVA VOCE ,Pass,232,58,290
M1610246, College : 4218  -  SKES S G S SCIENCE COLLEGE  BELAGAVI,DISTI,70.22,SOFTWARE PRACTICES AND TESTING ,Pass,60,12,72,BUSINESS INTELLIGENCE ,Pass,48,10,58,J2EE ,Pass,40,12,52,J2EE AND SOFTWARE TESTING LABORATORY,Pass,53,16,69,PROJECT AND VIVA VOCE ,Pass,227,58,285
M1610247, College : 4218  -  SKES S G S SCIENCE COLLEGE  BELAGAVI,N.C.L,--   ,SOFTWARE PRACTICES AND TESTING ,Pass,50,13,63,BUSINESS INTELLIGENCE ,Pass,41,17,58,J2EE ,Pass,45,13,58,J2EE AND SOFTWARE TESTING LABORATORY,Pass,32,8,40,PROJECT AND VIVA VOCE ,Pass,130,18,148
M1610248, College : 4218  -  SKES S G S SCIENCE COLLEGE  BELAGAVI,1ST C,66.92,SOFTWARE PRACTICES AND TESTING ,Pass,52,13,65,BUSINESS INTELLIGENCE ,Pass,51,16,67,J2EE ,Pass,50,13,63,J2EE AND SOFTWARE TESTING LABORATORY,Pass,50,17,67,PROJECT AND VIVA VOCE ,Pass,215,58,273
M1610249, College : 4218  -  SKES S G S SCIENCE COLLEGE  BELAGAVI,DISTI,87.05,SOFTWARE PRACTICES AND TESTING ,Pass,78,17,95,BUSINESS INTELLIGENCE ,Pass,75,20,95,J2EE ,Pass,75,17,92,J2EE AND SOFTWARE TESTING LABORATORY,Pass,75,20,95,PROJECT AND VIVA VOCE ,Pass,231,58,289
M1610250, College : 4218  -  SKES S G S SCIENCE COLLEGE  BELAGAVI,DISTI,84.08,SOFTWARE PRACTICES AND TESTING ,Pass,63,11,74,BUSINESS INTELLIGENCE ,Pass,76,19,95,J2EE ,Pass,63,17,80,J2EE AND SOFTWARE TESTING LABORATORY,Pass,72,20,92,PROJECT AND VIVA VOCE ,Pass,226,53,279
M1610251, College : 4218  -  SKES S G S SCIENCE COLLEGE  BELAGAVI,N.C.L,--   ,SOFTWARE PRACTICES AND TESTING ,Pass,61,14,75,BUSINESS INTELLIGENCE ,Pass,59,19,78,J2EE ,Pass,42,14,56,J2EE AND SOFTWARE TESTING LABORATORY,Pass,54,20,74,PROJECT AND VIVA VOCE ,Pass,210,58,268
M1610252, College : 4218  -  SKES S G S SCIENCE COLLEGE  BELAGAVI,N.C.L,--   ,SOFTWARE PRACTICES AND TESTING ,Pass,56,15,71,BUSINESS INTELLIGENCE ,Pass,56,13,69,J2EE ,Pass,34,13,47,J2EE AND SOFTWARE TESTING LABORATORY,Pass,65,20,85,PROJECT AND VIVA VOCE ,Pass,196,53,249
M1610253, College : 4218  -  SKES S G S SCIENCE COLLEGE  BELAGAVI,DISTI,87.73,SOFTWARE PRACTICES AND TESTING ,Pass,77,19,96,BUSINESS INTELLIGENCE ,Pass,78,19,97,J2EE ,Pass,64,15,79,J2EE AND SOFTWARE TESTING LABORATORY,Pass,78,20,98,PROJECT AND VIVA VOCE ,Pass,225,43,268
M1610254, College : 4218  -  SKES S G S SCIENCE COLLEGE  BELAGAVI,FAIL,6.71,SOFTWARE PRACTICES AND TESTING ,Fail,10,4,14,BUSINESS INTELLIGENCE ,Fail,Ab.,6,6,J2EE ,Fail,Ab.,6,6,J2EE AND SOFTWARE TESTING LABORATORY,Fail,Ab.,3,3,PROJECT AND VIVA VOCE ,Fail,Ab.,18,18
M1610255, College : 4218  -  SKES S G S SCIENCE COLLEGE  BELAGAVI,DISTI,80.95,SOFTWARE PRACTICES AND TESTING ,Pass,66,19,85,BUSINESS INTELLIGENCE ,Pass,62,16,78,J2EE ,Pass,58,12,70,J2EE AND SOFTWARE TESTING LABORATORY,Pass,69,20,89,PROJECT AND VIVA VOCE ,Pass,212,53,265
M1610256, College : 4218  -  SKES S G S SCIENCE COLLEGE  BELAGAVI,DISTI,78.81,SOFTWARE PRACTICES AND TESTING ,Pass,61,17,78,BUSINESS INTELLIGENCE ,Pass,65,16,81,J2EE ,Pass,43,13,56,J2EE AND SOFTWARE TESTING LABORATORY,Pass,68,20,88,PROJECT AND VIVA VOCE ,Pass,231,53,284
M1610257, College : 4218  -  SKES S G S SCIENCE COLLEGE  BELAGAVI,FAIL,62.57,SOFTWARE PRACTICES AND TESTING ,Pass,51,8,59,BUSINESS INTELLIGENCE ,Pass,44,8,52,J2EE ,Fail,19,12,31,J2EE AND SOFTWARE TESTING LABORATORY,Pass,39,9,48,PROJECT AND VIVA VOCE ,Pass,195,53,248
M1610258, College : 4218  -  SKES S G S SCIENCE COLLEGE  BELAGAVI,DISTI,91.84,SOFTWARE PRACTICES AND TESTING ,Pass,75,20,95,BUSINESS INTELLIGENCE ,Pass,79,20,99,J2EE ,Pass,58,20,78,J2EE AND SOFTWARE TESTING LABORATORY,Pass,79,20,99,PROJECT AND VIVA VOCE ,Pass,238,60,298
M1610259, College : 4218  -  SKES S G S SCIENCE COLLEGE  BELAGAVI,DISTI,83.22,SOFTWARE PRACTICES AND TESTING ,Pass,60,19,79,BUSINESS INTELLIGENCE ,Pass,55,19,74,J2EE ,Pass,50,17,67,J2EE AND SOFTWARE TESTING LABORATORY,Pass,74,20,94,PROJECT AND VIVA VOCE ,Pass,228,53,281
M1610260, College : 4218  -  SKES S G S SCIENCE COLLEGE  BELAGAVI,DISTI,75.14,SOFTWARE PRACTICES AND TESTING ,Pass,56,15,71,BUSINESS INTELLIGENCE ,Pass,59,17,76,J2EE ,Pass,32,10,42,J2EE AND SOFTWARE TESTING LABORATORY,Pass,68,20,88,PROJECT AND VIVA VOCE ,Pass,221,53,274
M1610261, College : 4218  -  SKES S G S SCIENCE COLLEGE  BELAGAVI,2ND C,58.51,SOFTWARE PRACTICES AND TESTING ,Pass,52,10,62,BUSINESS INTELLIGENCE ,Pass,47,11,58,J2EE ,Pass,36,10,46,J2EE AND SOFTWARE TESTING LABORATORY,Pass,37,15,52,PROJECT AND VIVA VOCE ,Pass,205,38,243
M1610262, College : 4218  -  SKES S G S SCIENCE COLLEGE  BELAGAVI,DISTI,81.59,SOFTWARE PRACTICES AND TESTING ,Pass,52,14,66,BUSINESS INTELLIGENCE ,Pass,43,16,59,J2EE ,Pass,43,12,55,J2EE AND SOFTWARE TESTING LABORATORY,Pass,62,20,82,PROJECT AND VIVA VOCE ,Pass,229,53,282
M1610263, College : 4218  -  SKES S G S SCIENCE COLLEGE  BELAGAVI,DISTI,88,SOFTWARE PRACTICES AND TESTING ,Pass,72,18,90,BUSINESS INTELLIGENCE ,Pass,48,19,67,J2EE ,Pass,62,15,77,J2EE AND SOFTWARE TESTING LABORATORY,Pass,77,20,97,PROJECT AND VIVA VOCE ,Pass,238,58,296
M1610265, College : 4218  -  SKES S G S SCIENCE COLLEGE  BELAGAVI,DISTI,83.38,SOFTWARE PRACTICES AND TESTING ,Pass,73,15,88,BUSINESS INTELLIGENCE ,Pass,65,18,83,J2EE ,Pass,56,17,73,J2EE AND SOFTWARE TESTING LABORATORY,Pass,77,20,97,PROJECT AND VIVA VOCE ,Pass,232,58,290
M1610266, College : 4218  -  SKES S G S SCIENCE COLLEGE  BELAGAVI,DISTI,87.05,SOFTWARE PRACTICES AND TESTING ,Pass,72,18,90,BUSINESS INTELLIGENCE ,Pass,58,18,76,J2EE ,Pass,65,16,81,J2EE AND SOFTWARE TESTING LABORATORY,Pass,71,20,91,PROJECT AND VIVA VOCE ,Pass,225,58,283
M1610267, College : 4218  -  SKES S G S SCIENCE COLLEGE  BELAGAVI,1ST C,61.81,SOFTWARE PRACTICES AND TESTING ,Pass,52,10,62,BUSINESS INTELLIGENCE ,Pass,35,10,45,J2EE ,Pass,36,8,44,J2EE AND SOFTWARE TESTING LABORATORY,Pass,63,12,75,PROJECT AND VIVA VOCE ,Pass,221,53,274
M1610268, College : 4218  -  SKES S G S SCIENCE COLLEGE  BELAGAVI,FAIL,37.29,SOFTWARE PRACTICES AND TESTING ,Fail,17,8,25,BUSINESS INTELLIGENCE ,Fail,18,16,34,J2EE ,Pass,32,8,40,J2EE AND SOFTWARE TESTING LABORATORY,Fail,16,8,24,PROJECT AND VIVA VOCE ,Pass,120,18,138
M1610269, College : 4218  -  SKES S G S SCIENCE COLLEGE  BELAGAVI,FAIL,17.71,SOFTWARE PRACTICES AND TESTING ,Pass,44,4,48,BUSINESS INTELLIGENCE ,Fail,19,16,35,J2EE ,Fail,14,6,20,J2EE AND SOFTWARE TESTING LABORATORY,Fail,Ab.,3,3,PROJECT AND VIVA VOCE ,Fail,Ab.,18,18
M1610270, College : 4218  -  SKES S G S SCIENCE COLLEGE  BELAGAVI,DISTI,72.84,SOFTWARE PRACTICES AND TESTING ,Pass,62,13,75,BUSINESS INTELLIGENCE ,Pass,43,16,59,J2EE ,Pass,44,13,57,J2EE AND SOFTWARE TESTING LABORATORY,Pass,48,20,68,PROJECT AND VIVA VOCE ,Pass,195,38,233
M1610271, College : 4218  -  SKES S G S SCIENCE COLLEGE  BELAGAVI,1ST C,66.08,SOFTWARE PRACTICES AND TESTING ,Pass,58,14,72,BUSINESS INTELLIGENCE ,Pass,50,14,64,J2EE ,Pass,38,14,52,J2EE AND SOFTWARE TESTING LABORATORY,Pass,72,20,92,PROJECT AND VIVA VOCE ,Pass,235,53,288
M1610272, College : 4218  -  SKES S G S SCIENCE COLLEGE  BELAGAVI,DISTI,91.65,SOFTWARE PRACTICES AND TESTING ,Pass,70,19,89,BUSINESS INTELLIGENCE ,Pass,60,20,80,J2EE ,Pass,70,16,86,J2EE AND SOFTWARE TESTING LABORATORY,Pass,79,20,99,PROJECT AND VIVA VOCE ,Pass,238,53,291
M1610273, College : 4218  -  SKES S G S SCIENCE COLLEGE  BELAGAVI,DISTI,80.92,SOFTWARE PRACTICES AND TESTING ,Pass,44,17,61,BUSINESS INTELLIGENCE ,Pass,41,15,56,J2EE ,Pass,50,13,63,J2EE AND SOFTWARE TESTING LABORATORY,Pass,75,17,92,PROJECT AND VIVA VOCE ,Pass,230,43,273
M1610274, College : 4218  -  SKES S G S SCIENCE COLLEGE  BELAGAVI,DISTI,76.41,SOFTWARE PRACTICES AND TESTING ,Pass,62,16,78,BUSINESS INTELLIGENCE ,Pass,74,18,92,J2EE ,Pass,47,16,63,J2EE AND SOFTWARE TESTING LABORATORY,Pass,60,20,80,PROJECT AND VIVA VOCE ,Pass,205,53,258
M1610275, College : 4218  -  SKES S G S SCIENCE COLLEGE  BELAGAVI,DISTI,73.57,SOFTWARE PRACTICES AND TESTING ,Pass,53,12,65,BUSINESS INTELLIGENCE ,Pass,60,9,69,J2EE ,Pass,41,9,50,J2EE AND SOFTWARE TESTING LABORATORY,Pass,67,16,83,PROJECT AND VIVA VOCE ,Pass,220,53,273
M1610276, College : 4218  -  SKES S G S SCIENCE COLLEGE  BELAGAVI,DISTI,82.54,SOFTWARE PRACTICES AND TESTING ,Pass,67,17,84,BUSINESS INTELLIGENCE ,Pass,52,19,71,J2EE ,Pass,66,16,82,J2EE AND SOFTWARE TESTING LABORATORY,Pass,74,20,94,PROJECT AND VIVA VOCE ,Pass,232,58,290
M1610277, College : 4218  -  SKES S G S SCIENCE COLLEGE  BELAGAVI,DISTI,83.81,SOFTWARE PRACTICES AND TESTING ,Pass,60,16,76,BUSINESS INTELLIGENCE ,Pass,67,19,86,J2EE ,Pass,56,15,71,J2EE AND SOFTWARE TESTING LABORATORY,Pass,56,20,76,PROJECT AND VIVA VOCE ,Pass,218,58,276
M1610278, College : 4218  -  SKES S G S SCIENCE COLLEGE  BELAGAVI,DISTI,90.08,SOFTWARE PRACTICES AND TESTING ,Pass,68,16,84,BUSINESS INTELLIGENCE ,Pass,76,20,96,J2EE ,Pass,71,16,87,J2EE AND SOFTWARE TESTING LABORATORY,Pass,76,20,96,PROJECT AND VIVA VOCE ,Pass,232,58,290
M1610279, College : 4218  -  SKES S G S SCIENCE COLLEGE  BELAGAVI,DISTI,72.35,SOFTWARE PRACTICES AND TESTING ,Pass,78,17,95,BUSINESS INTELLIGENCE ,Pass,73,18,91,J2EE ,Pass,62,19,81,J2EE AND SOFTWARE TESTING LABORATORY,Pass,47,20,67,PROJECT AND VIVA VOCE ,Pass,215,53,268
M1610280, College : 4218  -  SKES S G S SCIENCE COLLEGE  BELAGAVI,N.C.L,--   ,SOFTWARE PRACTICES AND TESTING ,Pass,65,18,83,BUSINESS INTELLIGENCE ,Pass,62,18,80,J2EE ,Pass,54,13,67,J2EE AND SOFTWARE TESTING LABORATORY,Pass,54,20,74,PROJECT AND VIVA VOCE ,Pass,217,53,270
M1610281, College : 4218  -  SKES S G S SCIENCE COLLEGE  BELAGAVI,2ND C,59.03,SOFTWARE PRACTICES AND TESTING ,Pass,40,10,50,BUSINESS INTELLIGENCE ,Pass,53,13,66,J2EE ,Pass,45,10,55,J2EE AND SOFTWARE TESTING LABORATORY,Pass,50,19,69,PROJECT AND VIVA VOCE ,Pass,130,28,158
M1610282, College : 4218  -  SKES S G S SCIENCE COLLEGE  BELAGAVI,DISTI,79,SOFTWARE PRACTICES AND TESTING ,Pass,74,13,87,BUSINESS INTELLIGENCE ,Pass,72,19,91,J2EE ,Pass,67,17,84,J2EE AND SOFTWARE TESTING LABORATORY,Pass,50,20,70,PROJECT AND VIVA VOCE ,Pass,228,53,281
M1610283, College : 4218  -  SKES S G S SCIENCE COLLEGE  BELAGAVI,1ST C,69.14,SOFTWARE PRACTICES AND TESTING ,Pass,58,14,72,BUSINESS INTELLIGENCE ,Pass,62,15,77,J2EE ,Pass,49,14,63,J2EE AND SOFTWARE TESTING LABORATORY,Pass,53,20,73,PROJECT AND VIVA VOCE ,Pass,215,58,273
M1610284, College : 4218  -  SKES S G S SCIENCE COLLEGE  BELAGAVI,DISTI,74,SOFTWARE PRACTICES AND TESTING ,Pass,62,8,70,BUSINESS INTELLIGENCE ,Pass,79,13,92,J2EE ,Pass,68,13,81,J2EE AND SOFTWARE TESTING LABORATORY,Pass,66,10,76,PROJECT AND VIVA VOCE ,Pass,227,53,280
M1610286, College : 4218  -  SKES S G S SCIENCE COLLEGE  BELAGAVI,DISTI,95.68,SOFTWARE PRACTICES AND TESTING ,Pass,77,20,97,BUSINESS INTELLIGENCE ,Pass,79,20,99,J2EE ,Pass,76,20,96,J2EE AND SOFTWARE TESTING LABORATORY,Pass,80,20,100,PROJECT AND VIVA VOCE ,Pass,239,60,299
M1610287, College : 4218  -  SKES S G S SCIENCE COLLEGE  BELAGAVI,DISTI,91.03,SOFTWARE PRACTICES AND TESTING ,Pass,72,19,91,BUSINESS INTELLIGENCE ,Pass,76,20,96,J2EE ,Pass,75,18,93,J2EE AND SOFTWARE TESTING LABORATORY,Pass,76,20,96,PROJECT AND VIVA VOCE ,Pass,235,53,288
M1610288, College : 4218  -  SKES S G S SCIENCE COLLEGE  BELAGAVI,FAIL,5.43,SOFTWARE PRACTICES AND TESTING ,Fail,1,4,5,BUSINESS INTELLIGENCE ,Fail,Ab.,6,6,J2EE ,Fail,Ab.,6,6,J2EE AND SOFTWARE TESTING LABORATORY,Fail,Ab.,3,3,PROJECT AND VIVA VOCE ,Fail,Ab.,18,18
M1610289, College : 4218  -  SKES S G S SCIENCE COLLEGE  BELAGAVI,1ST C,60.7,SOFTWARE PRACTICES AND TESTING ,Pass,58,12,70,BUSINESS INTELLIGENCE ,Pass,66,9,75,J2EE ,Pass,43,12,55,J2EE AND SOFTWARE TESTING LABORATORY,Pass,32,10,42,PROJECT AND VIVA VOCE ,Pass,230,43,273
M1610290, College : 4218  -  SKES S G S SCIENCE COLLEGE  BELAGAVI,DISTI,92.11,SOFTWARE PRACTICES AND TESTING ,Pass,76,20,96,BUSINESS INTELLIGENCE ,Pass,74,20,94,J2EE ,Pass,73,20,93,J2EE AND SOFTWARE TESTING LABORATORY,Pass,76,20,96,PROJECT AND VIVA VOCE ,Pass,230,60,290
M1610292, College : 4218  -  SKES S G S SCIENCE COLLEGE  BELAGAVI,1ST C,67.08,SOFTWARE PRACTICES AND TESTING ,Pass,61,9,70,BUSINESS INTELLIGENCE ,Pass,74,11,85,J2EE ,Pass,43,10,53,J2EE AND SOFTWARE TESTING LABORATORY,Pass,56,20,76,PROJECT AND VIVA VOCE ,Pass,217,53,270
M1610293, College : 4218  -  SKES S G S SCIENCE COLLEGE  BELAGAVI,2ND C,56.03,SOFTWARE PRACTICES AND TESTING ,Pass,55,8,63,BUSINESS INTELLIGENCE ,Pass,72,8,80,J2EE ,Pass,35,9,44,J2EE AND SOFTWARE TESTING LABORATORY,Pass,37,14,51,PROJECT AND VIVA VOCE ,Pass,195,33,228
M1610294, College : 4218  -  SKES S G S SCIENCE COLLEGE  BELAGAVI,DISTI,84.76,SOFTWARE PRACTICES AND TESTING ,Pass,61,19,80,BUSINESS INTELLIGENCE ,Pass,67,20,87,J2EE ,Pass,54,16,70,J2EE AND SOFTWARE TESTING LABORATORY,Pass,77,20,97,PROJECT AND VIVA VOCE ,Pass,225,53,278
M1610295, College : 4218  -  SKES S G S SCIENCE COLLEGE  BELAGAVI,N.C.L,--   ,SOFTWARE PRACTICES AND TESTING ,Pass,60,17,77,BUSINESS INTELLIGENCE ,Pass,44,16,60,J2EE ,Pass,51,14,65,J2EE AND SOFTWARE TESTING LABORATORY,Pass,69,20,89,PROJECT AND VIVA VOCE ,Pass,225,58,283
M1610296, College : 4218  -  SKES S G S SCIENCE COLLEGE  BELAGAVI,1ST C,68.59,SOFTWARE PRACTICES AND TESTING ,Pass,57,8,65,BUSINESS INTELLIGENCE ,Pass,53,8,61,J2EE ,Pass,54,10,64,J2EE AND SOFTWARE TESTING LABORATORY,Pass,60,13,73,PROJECT AND VIVA VOCE ,Pass,228,53,281
M1610297, College : 4218  -  SKES S G S SCIENCE COLLEGE  BELAGAVI,DISTI,81.59,SOFTWARE PRACTICES AND TESTING ,Pass,56,17,73,BUSINESS INTELLIGENCE ,Pass,59,14,73,J2EE ,Pass,64,15,79,J2EE AND SOFTWARE TESTING LABORATORY,Pass,79,20,99,PROJECT AND VIVA VOCE ,Pass,235,53,288
M1610298, College : 4218  -  SKES S G S SCIENCE COLLEGE  BELAGAVI,1ST C,69.16,SOFTWARE PRACTICES AND TESTING ,Pass,53,15,68,BUSINESS INTELLIGENCE ,Pass,43,12,55,J2EE ,Pass,65,11,76,J2EE AND SOFTWARE TESTING LABORATORY,Pass,77,20,97,PROJECT AND VIVA VOCE ,Pass,227,53,280
M1610299, College : 4218  -  SKES S G S SCIENCE COLLEGE  BELAGAVI,1ST C,62.86,SOFTWARE PRACTICES AND TESTING ,Pass,59,8,67,BUSINESS INTELLIGENCE ,Pass,34,8,42,J2EE ,Pass,45,8,53,J2EE AND SOFTWARE TESTING LABORATORY,Pass,62,8,70,PROJECT AND VIVA VOCE ,Pass,220,43,263
M1610401, College : 4219  -  KLS GOGTE COLLEGE OF COMMERCE  BELAGAVI,1ST C,66.19,SOFTWARE PRACTICES AND TESTING ,Pass,48,18,66,BUSINESS INTELLIGENCE ,Pass,59,18,77,J2EE ,Pass,37,14,51,J2EE AND SOFTWARE TESTING LABORATORY,Pass,51,15,66,PROJECT AND VIVA VOCE ,Pass,204,52,256
M1610402, College : 4219  -  KLS GOGTE COLLEGE OF COMMERCE  BELAGAVI,N.C.L,--   ,SOFTWARE PRACTICES AND TESTING ,Pass,51,16,67,BUSINESS INTELLIGENCE ,Pass,55,11,66,J2EE ,Pass,43,12,55,J2EE AND SOFTWARE TESTING LABORATORY,Pass,58,10,68,PROJECT AND VIVA VOCE ,Pass,201,50,251
M1610403, College : 4219  -  KLS GOGTE COLLEGE OF COMMERCE  BELAGAVI,N.C.L,--   ,SOFTWARE PRACTICES AND TESTING ,Pass,61,17,78,BUSINESS INTELLIGENCE ,Pass,79,19,98,J2EE ,Pass,60,18,78,J2EE AND SOFTWARE TESTING LABORATORY,Pass,66,15,81,PROJECT AND VIVA VOCE ,Pass,218,53,271
M1610405, College : 4219  -  KLS GOGTE COLLEGE OF COMMERCE  BELAGAVI,1ST C,68.14,SOFTWARE PRACTICES AND TESTING ,Pass,57,18,75,BUSINESS INTELLIGENCE ,Pass,63,18,81,J2EE ,Pass,44,16,60,J2EE AND SOFTWARE TESTING LABORATORY,Pass,62,18,80,PROJECT AND VIVA VOCE ,Pass,212,55,267
M1610406, College : 4219  -  KLS GOGTE COLLEGE OF COMMERCE  BELAGAVI,FAIL,56,SOFTWARE PRACTICES AND TESTING ,Fail,16,12,28,BUSINESS INTELLIGENCE ,Pass,32,10,42,J2EE ,Fail,3,10,13,J2EE AND SOFTWARE TESTING LABORATORY,Pass,45,14,59,PROJECT AND VIVA VOCE ,Pass,200,50,250
M1610407, College : 4219  -  KLS GOGTE COLLEGE OF COMMERCE  BELAGAVI,DISTI,73.46,SOFTWARE PRACTICES AND TESTING ,Pass,46,14,60,BUSINESS INTELLIGENCE ,Pass,49,16,65,J2EE ,Pass,53,12,65,J2EE AND SOFTWARE TESTING LABORATORY,Pass,50,12,62,PROJECT AND VIVA VOCE ,Pass,219,52,271
M1610408, College : 4219  -  KLS GOGTE COLLEGE OF COMMERCE  BELAGAVI,N.C.L,--   ,SOFTWARE PRACTICES AND TESTING ,Pass,39,16,55,BUSINESS INTELLIGENCE ,Pass,63,17,80,J2EE ,Pass,43,15,58,J2EE AND SOFTWARE TESTING LABORATORY,Pass,62,16,78,PROJECT AND VIVA VOCE ,Pass,218,56,274
M1610409, College : 4219  -  KLS GOGTE COLLEGE OF COMMERCE  BELAGAVI,FAIL,62.14,SOFTWARE PRACTICES AND TESTING ,Fail,17,10,27,BUSINESS INTELLIGENCE ,Pass,33,13,46,J2EE ,Pass,32,9,41,J2EE AND SOFTWARE TESTING LABORATORY,Pass,56,12,68,PROJECT AND VIVA VOCE ,Pass,200,53,253
M1610410, College : 4219  -  KLS GOGTE COLLEGE OF COMMERCE  BELAGAVI,N.C.L,--   ,SOFTWARE PRACTICES AND TESTING ,Pass,35,12,47,BUSINESS INTELLIGENCE ,Pass,37,13,50,J2EE ,Pass,32,12,44,J2EE AND SOFTWARE TESTING LABORATORY,Pass,52,12,64,PROJECT AND VIVA VOCE ,Pass,219,53,272
M1610411, College : 4219  -  KLS GOGTE COLLEGE OF COMMERCE  BELAGAVI,DISTI,72.76,SOFTWARE PRACTICES AND TESTING ,Pass,48,19,67,BUSINESS INTELLIGENCE ,Pass,68,15,83,J2EE ,Pass,45,17,62,J2EE AND SOFTWARE TESTING LABORATORY,Pass,51,12,63,PROJECT AND VIVA VOCE ,Pass,221,53,274
M1610412, College : 4219  -  KLS GOGTE COLLEGE OF COMMERCE  BELAGAVI,FAIL,60.43,SOFTWARE PRACTICES AND TESTING ,Fail,10,11,21,BUSINESS INTELLIGENCE ,Pass,42,8,50,J2EE ,Fail,21,8,29,J2EE AND SOFTWARE TESTING LABORATORY,Pass,63,10,73,PROJECT AND VIVA VOCE ,Pass,200,50,250
M1610414, College : 4219  -  KLS GOGTE COLLEGE OF COMMERCE  BELAGAVI,1ST C,66.51,SOFTWARE PRACTICES AND TESTING ,Pass,43,17,60,BUSINESS INTELLIGENCE ,Pass,65,18,83,J2EE ,Pass,45,16,61,J2EE AND SOFTWARE TESTING LABORATORY,Pass,69,17,86,PROJECT AND VIVA VOCE ,Pass,213,56,269
M1610415, College : 4219  -  KLS GOGTE COLLEGE OF COMMERCE  BELAGAVI,1ST C,68.73,SOFTWARE PRACTICES AND TESTING ,Pass,43,16,59,BUSINESS INTELLIGENCE ,Pass,64,17,81,J2EE ,Pass,37,15,52,J2EE AND SOFTWARE TESTING LABORATORY,Pass,55,17,72,PROJECT AND VIVA VOCE ,Pass,200,50,250
M1610416, College : 4219  -  KLS GOGTE COLLEGE OF COMMERCE  BELAGAVI,N.C.L,--   ,SOFTWARE PRACTICES AND TESTING ,Pass,43,17,60,BUSINESS INTELLIGENCE ,Pass,41,12,53,J2EE ,Pass,37,13,50,J2EE AND SOFTWARE TESTING LABORATORY,Pass,75,13,88,PROJECT AND VIVA VOCE ,Pass,221,54,275
M1610417, College : 4219  -  KLS GOGTE COLLEGE OF COMMERCE  BELAGAVI,FAIL,67.86,SOFTWARE PRACTICES AND TESTING ,Pass,43,16,59,BUSINESS INTELLIGENCE ,Pass,37,16,53,J2EE ,Fail,23,14,37,J2EE AND SOFTWARE TESTING LABORATORY,Pass,47,11,58,PROJECT AND VIVA VOCE ,Pass,215,53,268
M1610418, College : 4219  -  KLS GOGTE COLLEGE OF COMMERCE  BELAGAVI,1ST C,67.03,SOFTWARE PRACTICES AND TESTING ,Pass,49,12,61,BUSINESS INTELLIGENCE ,Pass,55,17,72,J2EE ,Pass,32,17,49,J2EE AND SOFTWARE TESTING LABORATORY,Pass,55,12,67,PROJECT AND VIVA VOCE ,Pass,220,56,276
M1610420, College : 4219  -  KLS GOGTE COLLEGE OF COMMERCE  BELAGAVI,DISTI,83.89,SOFTWARE PRACTICES AND TESTING ,Pass,61,20,81,BUSINESS INTELLIGENCE ,Pass,68,19,87,J2EE ,Pass,55,20,75,J2EE AND SOFTWARE TESTING LABORATORY,Pass,75,19,94,PROJECT AND VIVA VOCE ,Pass,231,58,289
M1610421, College : 4219  -  KLS GOGTE COLLEGE OF COMMERCE  BELAGAVI,1ST C,62.3,SOFTWARE PRACTICES AND TESTING ,Pass,60,18,78,BUSINESS INTELLIGENCE ,Pass,32,18,50,J2EE ,Pass,32,15,47,J2EE AND SOFTWARE TESTING LABORATORY,Pass,63,18,81,PROJECT AND VIVA VOCE ,Pass,230,58,288
M1610422, College : 4219  -  KLS GOGTE COLLEGE OF COMMERCE  BELAGAVI,1ST C,60,SOFTWARE PRACTICES AND TESTING ,Pass,54,16,70,BUSINESS INTELLIGENCE ,Pass,58,17,75,J2EE ,Pass,32,16,48,J2EE AND SOFTWARE TESTING LABORATORY,Pass,63,18,81,PROJECT AND VIVA VOCE ,Pass,216,56,272
M1610425, College : 4219  -  KLS GOGTE COLLEGE OF COMMERCE  BELAGAVI,DISTI,90.32,SOFTWARE PRACTICES AND TESTING ,Pass,68,20,88,BUSINESS INTELLIGENCE ,Pass,74,20,94,J2EE ,Pass,64,20,84,J2EE AND SOFTWARE TESTING LABORATORY,Pass,78,20,98,PROJECT AND VIVA VOCE ,Pass,240,60,300
M1610426, College : 4219  -  KLS GOGTE COLLEGE OF COMMERCE  BELAGAVI,N.C.L,--   ,SOFTWARE PRACTICES AND TESTING ,Pass,32,16,48,BUSINESS INTELLIGENCE ,Pass,45,14,59,J2EE ,Pass,45,14,59,J2EE AND SOFTWARE TESTING LABORATORY,Pass,57,16,73,PROJECT AND VIVA VOCE ,Pass,220,53,273
M1610427, College : 4219  -  KLS GOGTE COLLEGE OF COMMERCE  BELAGAVI,DISTI,92.11,SOFTWARE PRACTICES AND TESTING ,Pass,72,20,92,BUSINESS INTELLIGENCE ,Pass,77,20,97,J2EE ,Pass,56,20,76,J2EE AND SOFTWARE TESTING LABORATORY,Pass,80,20,100,PROJECT AND VIVA VOCE ,Pass,240,60,300
M1610428, College : 4219  -  KLS GOGTE COLLEGE OF COMMERCE  BELAGAVI,DISTI,78.27,SOFTWARE PRACTICES AND TESTING ,Pass,70,20,90,BUSINESS INTELLIGENCE ,Pass,64,20,84,J2EE ,Pass,41,19,60,J2EE AND SOFTWARE TESTING LABORATORY,Pass,76,17,93,PROJECT AND VIVA VOCE ,Pass,230,58,288
M1610429, College : 4219  -  KLS GOGTE COLLEGE OF COMMERCE  BELAGAVI,DISTI,87,SOFTWARE PRACTICES AND TESTING ,Pass,67,20,87,BUSINESS INTELLIGENCE ,Pass,68,19,87,J2EE ,Pass,61,19,80,J2EE AND SOFTWARE TESTING LABORATORY,Pass,76,20,96,PROJECT AND VIVA VOCE ,Pass,235,60,295
M1610430, College : 4219  -  KLS GOGTE COLLEGE OF COMMERCE  BELAGAVI,1ST C,69.08,SOFTWARE PRACTICES AND TESTING ,Pass,58,18,76,BUSINESS INTELLIGENCE ,Pass,58,18,76,J2EE ,Pass,39,15,54,J2EE AND SOFTWARE TESTING LABORATORY,Pass,50,8,58,PROJECT AND VIVA VOCE ,Pass,180,50,230
M1610431, College : 4219  -  KLS GOGTE COLLEGE OF COMMERCE  BELAGAVI,1ST C,68.92,SOFTWARE PRACTICES AND TESTING ,Pass,65,19,84,BUSINESS INTELLIGENCE ,Pass,64,19,83,J2EE ,Pass,51,15,66,J2EE AND SOFTWARE TESTING LABORATORY,Pass,58,17,75,PROJECT AND VIVA VOCE ,Pass,220,53,273
M1610432, College : 4219  -  KLS GOGTE COLLEGE OF COMMERCE  BELAGAVI,2ND C,59.59,SOFTWARE PRACTICES AND TESTING ,Pass,48,16,64,BUSINESS INTELLIGENCE ,Pass,53,17,70,J2EE ,Pass,32,13,45,J2EE AND SOFTWARE TESTING LABORATORY,Pass,53,12,65,PROJECT AND VIVA VOCE ,Pass,220,53,273
M1610433, College : 4219  -  KLS GOGTE COLLEGE OF COMMERCE  BELAGAVI,FAIL,66.43,SOFTWARE PRACTICES AND TESTING ,Pass,41,14,55,BUSINESS INTELLIGENCE ,Pass,32,18,50,J2EE ,Fail,20,14,34,J2EE AND SOFTWARE TESTING LABORATORY,Pass,52,12,64,PROJECT AND VIVA VOCE ,Pass,210,52,262
M1610434, College : 4219  -  KLS GOGTE COLLEGE OF COMMERCE  BELAGAVI,DISTI,79.46,SOFTWARE PRACTICES AND TESTING ,Pass,65,19,84,BUSINESS INTELLIGENCE ,Pass,67,19,86,J2EE ,Pass,48,15,63,J2EE AND SOFTWARE TESTING LABORATORY,Pass,75,18,93,PROJECT AND VIVA VOCE ,Pass,221,56,277
M1610435, College : 4219  -  KLS GOGTE COLLEGE OF COMMERCE  BELAGAVI,1ST C,67.38,SOFTWARE PRACTICES AND TESTING ,Pass,48,19,67,BUSINESS INTELLIGENCE ,Pass,32,20,52,J2EE ,Pass,32,12,44,J2EE AND SOFTWARE TESTING LABORATORY,Pass,59,15,74,PROJECT AND VIVA VOCE ,Pass,219,54,273
M1610437, College : 4219  -  KLS GOGTE COLLEGE OF COMMERCE  BELAGAVI,1ST C,67.78,SOFTWARE PRACTICES AND TESTING ,Pass,52,17,69,BUSINESS INTELLIGENCE ,Pass,35,18,53,J2EE ,Pass,42,13,55,J2EE AND SOFTWARE TESTING LABORATORY,Pass,51,18,69,PROJECT AND VIVA VOCE ,Pass,220,56,276
M1610438, College : 4219  -  KLS GOGTE COLLEGE OF COMMERCE  BELAGAVI,2ND C,59.35,SOFTWARE PRACTICES AND TESTING ,Pass,38,10,48,BUSINESS INTELLIGENCE ,Pass,32,15,47,J2EE ,Pass,36,9,45,J2EE AND SOFTWARE TESTING LABORATORY,Pass,51,10,61,PROJECT AND VIVA VOCE ,Pass,210,50,260
M1610439, College : 4219  -  KLS GOGTE COLLEGE OF COMMERCE  BELAGAVI,FAIL,68.43,SOFTWARE PRACTICES AND TESTING ,Pass,36,12,48,BUSINESS INTELLIGENCE ,Pass,52,12,64,J2EE ,Fail,22,12,34,J2EE AND SOFTWARE TESTING LABORATORY,Pass,55,12,67,PROJECT AND VIVA VOCE ,Pass,216,50,266
M1610440, College : 4219  -  KLS GOGTE COLLEGE OF COMMERCE  BELAGAVI,FAIL,75,SOFTWARE PRACTICES AND TESTING ,Pass,46,18,64,BUSINESS INTELLIGENCE ,Pass,66,17,83,J2EE ,Fail,19,13,32,J2EE AND SOFTWARE TESTING LABORATORY,Pass,62,12,74,PROJECT AND VIVA VOCE ,Pass,220,52,272
M1610441, College : 4219  -  KLS GOGTE COLLEGE OF COMMERCE  BELAGAVI,DISTI,81.46,SOFTWARE PRACTICES AND TESTING ,Pass,65,18,83,BUSINESS INTELLIGENCE ,Pass,73,18,91,J2EE ,Pass,48,18,66,J2EE AND SOFTWARE TESTING LABORATORY,Pass,78,20,98,PROJECT AND VIVA VOCE ,Pass,239,60,299
M1610443, College : 4219  -  KLS GOGTE COLLEGE OF COMMERCE  BELAGAVI,DISTI,77.97,SOFTWARE PRACTICES AND TESTING ,Pass,61,19,80,BUSINESS INTELLIGENCE ,Pass,59,17,76,J2EE ,Pass,54,16,70,J2EE AND SOFTWARE TESTING LABORATORY,Pass,61,18,79,PROJECT AND VIVA VOCE ,Pass,226,54,280
M1610444, College : 4219  -  KLS GOGTE COLLEGE OF COMMERCE  BELAGAVI,DISTI,88.32,SOFTWARE PRACTICES AND TESTING ,Pass,64,20,84,BUSINESS INTELLIGENCE ,Pass,56,18,74,J2EE ,Pass,58,18,76,J2EE AND SOFTWARE TESTING LABORATORY,Pass,70,19,89,PROJECT AND VIVA VOCE ,Pass,231,58,289
M1610445, College : 4219  -  KLS GOGTE COLLEGE OF COMMERCE  BELAGAVI,FAIL,66.14,SOFTWARE PRACTICES AND TESTING ,Pass,48,16,64,BUSINESS INTELLIGENCE ,Pass,32,17,49,J2EE ,Fail,24,10,34,J2EE AND SOFTWARE TESTING LABORATORY,Pass,51,10,61,PROJECT AND VIVA VOCE ,Pass,201,54,255
M1610446, College : 4219  -  KLS GOGTE COLLEGE OF COMMERCE  BELAGAVI,DISTI,75.89,SOFTWARE PRACTICES AND TESTING ,Pass,49,20,69,BUSINESS INTELLIGENCE ,Pass,46,18,64,J2EE ,Pass,41,18,59,J2EE AND SOFTWARE TESTING LABORATORY,Pass,76,19,95,PROJECT AND VIVA VOCE ,Pass,230,54,284
M1610447, College : 4219  -  KLS GOGTE COLLEGE OF COMMERCE  BELAGAVI,1ST C,68.59,SOFTWARE PRACTICES AND TESTING ,Pass,47,14,61,BUSINESS INTELLIGENCE ,Pass,52,17,69,J2EE ,Pass,47,13,60,J2EE AND SOFTWARE TESTING LABORATORY,Pass,69,15,84,PROJECT AND VIVA VOCE ,Pass,210,54,264
M1610448, College : 4219  -  KLS GOGTE COLLEGE OF COMMERCE  BELAGAVI,1ST C,65.73,SOFTWARE PRACTICES AND TESTING ,Pass,50,19,69,BUSINESS INTELLIGENCE ,Pass,46,16,62,J2EE ,Pass,42,14,56,J2EE AND SOFTWARE TESTING LABORATORY,Pass,58,15,73,PROJECT AND VIVA VOCE ,Pass,226,53,279
M1610449, College : 4219  -  KLS GOGTE COLLEGE OF COMMERCE  BELAGAVI,DISTI,70,SOFTWARE PRACTICES AND TESTING ,Pass,70,16,86,BUSINESS INTELLIGENCE ,Pass,48,18,66,J2EE ,Pass,44,15,59,J2EE AND SOFTWARE TESTING LABORATORY,Pass,74,10,84,PROJECT AND VIVA VOCE ,Pass,221,56,277
M1610450, College : 4219  -  KLS GOGTE COLLEGE OF COMMERCE  BELAGAVI,1ST C,64.27,SOFTWARE PRACTICES AND TESTING ,Pass,62,19,81,BUSINESS INTELLIGENCE ,Pass,45,18,63,J2EE ,Pass,39,17,56,J2EE AND SOFTWARE TESTING LABORATORY,Pass,50,18,68,PROJECT AND VIVA VOCE ,Pass,209,53,262
M1610451, College : 4219  -  KLS GOGTE COLLEGE OF COMMERCE  BELAGAVI,DISTI,72.24,SOFTWARE PRACTICES AND TESTING ,Pass,66,18,84,BUSINESS INTELLIGENCE ,Pass,65,17,82,J2EE ,Pass,56,16,72,J2EE AND SOFTWARE TESTING LABORATORY,Pass,62,17,79,PROJECT AND VIVA VOCE ,Pass,220,55,275
M1610452, College : 4219  -  KLS GOGTE COLLEGE OF COMMERCE  BELAGAVI,FAIL,66.14,SOFTWARE PRACTICES AND TESTING ,Fail,Ab.,15,15,BUSINESS INTELLIGENCE ,Pass,32,17,49,J2EE ,Pass,50,14,64,J2EE AND SOFTWARE TESTING LABORATORY,Pass,56,15,71,PROJECT AND VIVA VOCE ,Pass,210,54,264
M1610453, College : 4219  -  KLS GOGTE COLLEGE OF COMMERCE  BELAGAVI,DISTI,83.3,SOFTWARE PRACTICES AND TESTING ,Pass,63,20,83,BUSINESS INTELLIGENCE ,Pass,45,20,65,J2EE ,Pass,72,18,90,J2EE AND SOFTWARE TESTING LABORATORY,Pass,80,20,100,PROJECT AND VIVA VOCE ,Pass,239,60,299
M1610454, College : 4219  -  KLS GOGTE COLLEGE OF COMMERCE  BELAGAVI,N.C.L,--   ,SOFTWARE PRACTICES AND TESTING ,Pass,33,13,46,BUSINESS INTELLIGENCE ,Pass,32,13,45,J2EE ,Pass,44,10,54,J2EE AND SOFTWARE TESTING LABORATORY,Pass,50,10,60,PROJECT AND VIVA VOCE ,Pass,201,53,254
M1610455, College : 4219  -  KLS GOGTE COLLEGE OF COMMERCE  BELAGAVI,1ST C,68.16,SOFTWARE PRACTICES AND TESTING ,Pass,52,18,70,BUSINESS INTELLIGENCE ,Pass,38,17,55,J2EE ,Pass,62,15,77,J2EE AND SOFTWARE TESTING LABORATORY,Pass,61,17,78,PROJECT AND VIVA VOCE ,Pass,226,54,280
M1610456, College : 4219  -  KLS GOGTE COLLEGE OF COMMERCE  BELAGAVI,1ST C,62.19,SOFTWARE PRACTICES AND TESTING ,Pass,44,18,62,BUSINESS INTELLIGENCE ,Pass,49,14,63,J2EE ,Pass,43,15,58,J2EE AND SOFTWARE TESTING LABORATORY,Pass,51,13,64,PROJECT AND VIVA VOCE ,Pass,209,53,262
M1610601, College : 4232  -  BHARATESH COLLEGE OF COMPUTER APPLICATION  BELAGAVI,1ST C,67.73,SOFTWARE PRACTICES AND TESTING ,Pass,37,19,56,BUSINESS INTELLIGENCE ,Pass,45,18,63,J2EE ,Pass,41,17,58,J2EE AND SOFTWARE TESTING LABORATORY,Pass,73,18,91,PROJECT AND VIVA VOCE ,Pass,220,50,270
M1610602, College : 4232  -  BHARATESH COLLEGE OF COMPUTER APPLICATION  BELAGAVI,DISTI,78.57,SOFTWARE PRACTICES AND TESTING ,Pass,53,17,70,BUSINESS INTELLIGENCE ,Pass,45,16,61,J2EE ,Pass,54,16,70,J2EE AND SOFTWARE TESTING LABORATORY,Pass,74,17,91,PROJECT AND VIVA VOCE ,Pass,216,49,265
M1610604, College : 4232  -  BHARATESH COLLEGE OF COMPUTER APPLICATION  BELAGAVI,N.C.L,--   ,SOFTWARE PRACTICES AND TESTING ,Pass,37,15,52,BUSINESS INTELLIGENCE ,Pass,32,14,46,J2EE ,Pass,51,13,64,J2EE AND SOFTWARE TESTING LABORATORY,Pass,41,17,58,PROJECT AND VIVA VOCE ,Pass,213,45,258
M1610607, College : 4232  -  BHARATESH COLLEGE OF COMPUTER APPLICATION  BELAGAVI,N.C.L,--   ,SOFTWARE PRACTICES AND TESTING ,Pass,40,19,59,BUSINESS INTELLIGENCE ,Pass,33,18,51,J2EE ,Pass,47,16,63,J2EE AND SOFTWARE TESTING LABORATORY,Pass,75,18,93,PROJECT AND VIVA VOCE ,Pass,230,50,280
M1610608, College : 4232  -  BHARATESH COLLEGE OF COMPUTER APPLICATION  BELAGAVI,DISTI,77.92,SOFTWARE PRACTICES AND TESTING ,Pass,64,19,83,BUSINESS INTELLIGENCE ,Pass,66,20,86,J2EE ,Pass,66,17,83,J2EE AND SOFTWARE TESTING LABORATORY,Pass,72,18,90,PROJECT AND VIVA VOCE ,Pass,208,50,258
M1610609, College : 4232  -  BHARATESH COLLEGE OF COMPUTER APPLICATION  BELAGAVI,DISTI,80.46,SOFTWARE PRACTICES AND TESTING ,Pass,70,19,89,BUSINESS INTELLIGENCE ,Pass,58,20,78,J2EE ,Pass,64,19,83,J2EE AND SOFTWARE TESTING LABORATORY,Pass,77,19,96,PROJECT AND VIVA VOCE ,Pass,210,50,260
M1610611, College : 4232  -  BHARATESH COLLEGE OF COMPUTER APPLICATION  BELAGAVI,N.C.L,--   ,SOFTWARE PRACTICES AND TESTING ,Pass,54,14,68,BUSINESS INTELLIGENCE ,Pass,50,14,64,J2EE ,Pass,52,13,65,J2EE AND SOFTWARE TESTING LABORATORY,Pass,57,16,73,PROJECT AND VIVA VOCE ,Pass,190,30,220
M1610612, College : 4232  -  BHARATESH COLLEGE OF COMPUTER APPLICATION  BELAGAVI,DISTI,80.7,SOFTWARE PRACTICES AND TESTING ,Pass,60,15,75,BUSINESS INTELLIGENCE ,Pass,55,19,74,J2EE ,Pass,60,16,76,J2EE AND SOFTWARE TESTING LABORATORY,Pass,70,16,86,PROJECT AND VIVA VOCE ,Pass,214,40,254
M1610613, College : 4232  -  BHARATESH COLLEGE OF COMPUTER APPLICATION  BELAGAVI,DISTI,77.81,SOFTWARE PRACTICES AND TESTING ,Pass,65,19,84,BUSINESS INTELLIGENCE ,Pass,60,20,80,J2EE ,Pass,57,17,74,J2EE AND SOFTWARE TESTING LABORATORY,Pass,77,18,95,PROJECT AND VIVA VOCE ,Pass,206,50,256
M1610614, College : 4232  -  BHARATESH COLLEGE OF COMPUTER APPLICATION  BELAGAVI,DISTI,76.32,SOFTWARE PRACTICES AND TESTING ,Pass,56,19,75,BUSINESS INTELLIGENCE ,Pass,57,20,77,J2EE ,Pass,42,19,61,J2EE AND SOFTWARE TESTING LABORATORY,Pass,74,18,92,PROJECT AND VIVA VOCE ,Pass,210,45,255
M1610615, College : 4232  -  BHARATESH COLLEGE OF COMPUTER APPLICATION  BELAGAVI,DISTI,75.51,SOFTWARE PRACTICES AND TESTING ,Pass,59,19,78,BUSINESS INTELLIGENCE ,Pass,59,19,78,J2EE ,Pass,58,19,77,J2EE AND SOFTWARE TESTING LABORATORY,Pass,72,18,90,PROJECT AND VIVA VOCE ,Pass,215,48,263
M1610617, College : 4232  -  BHARATESH COLLEGE OF COMPUTER APPLICATION  BELAGAVI,DISTI,72.49,SOFTWARE PRACTICES AND TESTING ,Pass,63,19,82,BUSINESS INTELLIGENCE ,Pass,59,18,77,J2EE ,Pass,53,16,69,J2EE AND SOFTWARE TESTING LABORATORY,Pass,75,18,93,PROJECT AND VIVA VOCE ,Pass,210,48,258
M1610618, College : 4232  -  BHARATESH COLLEGE OF COMPUTER APPLICATION  BELAGAVI,N.C.L,--   ,SOFTWARE PRACTICES AND TESTING ,Pass,43,14,57,BUSINESS INTELLIGENCE ,Pass,32,13,45,J2EE ,Pass,32,14,46,J2EE AND SOFTWARE TESTING LABORATORY,Pass,65,14,79,PROJECT AND VIVA VOCE ,Pass,205,40,245
M1610619, College : 4232  -  BHARATESH COLLEGE OF COMPUTER APPLICATION  BELAGAVI,DISTI,73.81,SOFTWARE PRACTICES AND TESTING ,Pass,54,19,73,BUSINESS INTELLIGENCE ,Pass,51,20,71,J2EE ,Pass,48,17,65,J2EE AND SOFTWARE TESTING LABORATORY,Pass,76,18,94,PROJECT AND VIVA VOCE ,Pass,212,50,262
M1610620, College : 4232  -  BHARATESH COLLEGE OF COMPUTER APPLICATION  BELAGAVI,DISTI,74.73,SOFTWARE PRACTICES AND TESTING ,Pass,58,19,77,BUSINESS INTELLIGENCE ,Pass,57,20,77,J2EE ,Pass,53,19,72,J2EE AND SOFTWARE TESTING LABORATORY,Pass,70,18,88,PROJECT AND VIVA VOCE ,Pass,206,46,252
M1610621, College : 4232  -  BHARATESH COLLEGE OF COMPUTER APPLICATION  BELAGAVI,DISTI,72.92,SOFTWARE PRACTICES AND TESTING ,Pass,43,19,62,BUSINESS INTELLIGENCE ,Pass,44,18,62,J2EE ,Pass,47,18,65,J2EE AND SOFTWARE TESTING LABORATORY,Pass,74,18,92,PROJECT AND VIVA VOCE ,Pass,210,43,253
M1610622, College : 4232  -  BHARATESH COLLEGE OF COMPUTER APPLICATION  BELAGAVI,DISTI,70.89,SOFTWARE PRACTICES AND TESTING ,Pass,54,18,72,BUSINESS INTELLIGENCE ,Pass,43,16,59,J2EE ,Pass,43,16,59,J2EE AND SOFTWARE TESTING LABORATORY,Pass,70,18,88,PROJECT AND VIVA VOCE ,Pass,215,50,265
M1610624, College : 4232  -  BHARATESH COLLEGE OF COMPUTER APPLICATION  BELAGAVI,DISTI,75.11,SOFTWARE PRACTICES AND TESTING ,Pass,56,18,74,BUSINESS INTELLIGENCE ,Pass,44,17,61,J2EE ,Pass,49,16,65,J2EE AND SOFTWARE TESTING LABORATORY,Pass,75,17,92,PROJECT AND VIVA VOCE ,Pass,210,48,258
M1610625, College : 4232  -  BHARATESH COLLEGE OF COMPUTER APPLICATION  BELAGAVI,N.C.L,--   ,SOFTWARE PRACTICES AND TESTING ,Pass,42,16,58,BUSINESS INTELLIGENCE ,Pass,32,13,45,J2EE ,Pass,34,15,49,J2EE AND SOFTWARE TESTING LABORATORY,Pass,68,18,86,PROJECT AND VIVA VOCE ,Pass,204,38,242
M1610626, College : 4232  -  BHARATESH COLLEGE OF COMPUTER APPLICATION  BELAGAVI,N.C.L,--   ,SOFTWARE PRACTICES AND TESTING ,Pass,52,14,66,BUSINESS INTELLIGENCE ,Pass,32,12,44,J2EE ,Pass,37,14,51,J2EE AND SOFTWARE TESTING LABORATORY,Pass,52,16,68,PROJECT AND VIVA VOCE ,Pass,201,40,241
M1610627, College : 4232  -  BHARATESH COLLEGE OF COMPUTER APPLICATION  BELAGAVI,FAIL,63.86,SOFTWARE PRACTICES AND TESTING ,Pass,32,17,49,BUSINESS INTELLIGENCE ,Fail,17,12,29,J2EE ,Pass,32,16,48,J2EE AND SOFTWARE TESTING LABORATORY,Pass,61,14,75,PROJECT AND VIVA VOCE ,Pass,204,42,246
M1610628, College : 4232  -  BHARATESH COLLEGE OF COMPUTER APPLICATION  BELAGAVI,DISTI,74.84,SOFTWARE PRACTICES AND TESTING ,Pass,59,18,77,BUSINESS INTELLIGENCE ,Pass,54,17,71,J2EE ,Pass,43,16,59,J2EE AND SOFTWARE TESTING LABORATORY,Pass,74,16,90,PROJECT AND VIVA VOCE ,Pass,212,50,262
M1610801, College : 4233  -  PES COLLEGE OF CORPORATE SECRETARYSHIP  BELAGAVI,DISTI,71.7,SOFTWARE PRACTICES AND TESTING ,Pass,60,12,72,BUSINESS INTELLIGENCE ,Pass,53,10,63,J2EE ,Pass,49,16,65,J2EE AND SOFTWARE TESTING LABORATORY,Pass,71,14,85,PROJECT AND VIVA VOCE ,Pass,223,47,270
M1610802, College : 4233  -  PES COLLEGE OF CORPORATE SECRETARYSHIP  BELAGAVI,1ST C,61.41,SOFTWARE PRACTICES AND TESTING ,Pass,47,8,55,BUSINESS INTELLIGENCE ,Pass,40,9,49,J2EE ,Pass,43,8,51,J2EE AND SOFTWARE TESTING LABORATORY,Pass,32,11,43,PROJECT AND VIVA VOCE ,Pass,175,47,222
M1610803, College : 4233  -  PES COLLEGE OF CORPORATE SECRETARYSHIP  BELAGAVI,N.C.L,--   ,SOFTWARE PRACTICES AND TESTING ,Pass,45,9,54,BUSINESS INTELLIGENCE ,Pass,51,10,61,J2EE ,Pass,34,12,46,J2EE AND SOFTWARE TESTING LABORATORY,Pass,63,9,72,PROJECT AND VIVA VOCE ,Pass,183,42,225
M1610805, College : 4233  -  PES COLLEGE OF CORPORATE SECRETARYSHIP  BELAGAVI,FAIL,40.14,SOFTWARE PRACTICES AND TESTING ,Pass,35,6,41,BUSINESS INTELLIGENCE ,Pass,50,8,58,J2EE ,Fail,18,5,23,J2EE AND SOFTWARE TESTING LABORATORY,Fail,5,4,9,PROJECT AND VIVA VOCE ,Pass,124,26,150
M1610806, College : 4233  -  PES COLLEGE OF CORPORATE SECRETARYSHIP  BELAGAVI,N.C.L,--   ,SOFTWARE PRACTICES AND TESTING ,Pass,37,10,47,BUSINESS INTELLIGENCE ,Pass,57,11,68,J2EE ,Pass,32,12,44,J2EE AND SOFTWARE TESTING LABORATORY,Pass,40,8,48,PROJECT AND VIVA VOCE ,Pass,184,41,225
M1610807, College : 4233  -  PES COLLEGE OF CORPORATE SECRETARYSHIP  BELAGAVI,FAIL,31.86,SOFTWARE PRACTICES AND TESTING ,Fail,Ab.,8,8,BUSINESS INTELLIGENCE ,Fail,Ab.,8,8,J2EE ,Fail,Ab.,8,8,J2EE AND SOFTWARE TESTING LABORATORY,Fail,Ab.,4,4,PROJECT AND VIVA VOCE ,Pass,160,35,195
M1610808, College : 4233  -  PES COLLEGE OF CORPORATE SECRETARYSHIP  BELAGAVI,DISTI,81.43,SOFTWARE PRACTICES AND TESTING ,Pass,52,16,68,BUSINESS INTELLIGENCE ,Pass,60,18,78,J2EE ,Pass,68,20,88,J2EE AND SOFTWARE TESTING LABORATORY,Pass,76,18,94,PROJECT AND VIVA VOCE ,Pass,215,49,264
M1610809, College : 4233  -  PES COLLEGE OF CORPORATE SECRETARYSHIP  BELAGAVI,FAIL,41.57,SOFTWARE PRACTICES AND TESTING ,Pass,34,8,42,BUSINESS INTELLIGENCE ,Fail,16,8,24,J2EE ,Pass,32,8,40,J2EE AND SOFTWARE TESTING LABORATORY,Pass,33,11,44,PROJECT AND VIVA VOCE ,Pass,115,26,141
M1610810, College : 4233  -  PES COLLEGE OF CORPORATE SECRETARYSHIP  BELAGAVI,DISTI,74.7,SOFTWARE PRACTICES AND TESTING ,Pass,66,16,82,BUSINESS INTELLIGENCE ,Pass,60,17,77,J2EE ,Pass,41,19,60,J2EE AND SOFTWARE TESTING LABORATORY,Pass,70,18,88,PROJECT AND VIVA VOCE ,Pass,195,48,243
M1610811, College : 4233  -  PES COLLEGE OF CORPORATE SECRETARYSHIP  BELAGAVI,FAIL,68.29,SOFTWARE PRACTICES AND TESTING ,Pass,50,16,66,BUSINESS INTELLIGENCE ,Pass,54,20,74,J2EE ,Fail,21,18,39,J2EE AND SOFTWARE TESTING LABORATORY,Pass,79,20,99,PROJECT AND VIVA VOCE ,Pass,150,50,200
M1610812, College : 4233  -  PES COLLEGE OF CORPORATE SECRETARYSHIP  BELAGAVI,DISTI,81.89,SOFTWARE PRACTICES AND TESTING ,Pass,57,15,72,BUSINESS INTELLIGENCE ,Pass,65,16,81,J2EE ,Pass,48,19,67,J2EE AND SOFTWARE TESTING LABORATORY,Pass,75,13,88,PROJECT AND VIVA VOCE ,Pass,224,48,272
M1610813, College : 4233  -  PES COLLEGE OF CORPORATE SECRETARYSHIP  BELAGAVI,1ST C,63.22,SOFTWARE PRACTICES AND TESTING ,Pass,41,12,53,BUSINESS INTELLIGENCE ,Pass,47,12,59,J2EE ,Pass,38,16,54,J2EE AND SOFTWARE TESTING LABORATORY,Pass,49,12,61,PROJECT AND VIVA VOCE ,Pass,204,45,249
M1610814, College : 4233  -  PES COLLEGE OF CORPORATE SECRETARYSHIP  BELAGAVI,N.C.L,--   ,SOFTWARE PRACTICES AND TESTING ,Pass,43,11,54,BUSINESS INTELLIGENCE ,Pass,41,17,58,J2EE ,Pass,32,15,47,J2EE AND SOFTWARE TESTING LABORATORY,Pass,58,15,73,PROJECT AND VIVA VOCE ,Pass,204,47,251
M1610815, College : 4233  -  PES COLLEGE OF CORPORATE SECRETARYSHIP  BELAGAVI,DISTI,71.32,SOFTWARE PRACTICES AND TESTING ,Pass,57,16,73,BUSINESS INTELLIGENCE ,Pass,63,17,80,J2EE ,Pass,36,19,55,J2EE AND SOFTWARE TESTING LABORATORY,Pass,40,18,58,PROJECT AND VIVA VOCE ,Pass,195,48,243
M1610816, College : 4233  -  PES COLLEGE OF CORPORATE SECRETARYSHIP  BELAGAVI,DISTI,85.78,SOFTWARE PRACTICES AND TESTING ,Pass,75,19,94,BUSINESS INTELLIGENCE ,Pass,75,20,95,J2EE ,Pass,72,14,86,J2EE AND SOFTWARE TESTING LABORATORY,Pass,75,15,90,PROJECT AND VIVA VOCE ,Pass,229,54,283
M1610817, College : 4233  -  PES COLLEGE OF CORPORATE SECRETARYSHIP  BELAGAVI,N.C.L,--   ,SOFTWARE PRACTICES AND TESTING ,Pass,51,11,62,BUSINESS INTELLIGENCE ,Pass,46,8,54,J2EE ,Pass,36,15,51,J2EE AND SOFTWARE TESTING LABORATORY,Pass,53,12,65,PROJECT AND VIVA VOCE ,Pass,200,45,245
M1610818, College : 4233  -  PES COLLEGE OF CORPORATE SECRETARYSHIP  BELAGAVI,DISTI,78.62,SOFTWARE PRACTICES AND TESTING ,Pass,66,14,80,BUSINESS INTELLIGENCE ,Pass,70,14,84,J2EE ,Pass,53,18,71,J2EE AND SOFTWARE TESTING LABORATORY,Pass,70,18,88,PROJECT AND VIVA VOCE ,Pass,215,45,260
M1610819, College : 4233  -  PES COLLEGE OF CORPORATE SECRETARYSHIP  BELAGAVI,N.C.L,--   ,SOFTWARE PRACTICES AND TESTING ,Pass,48,12,60,BUSINESS INTELLIGENCE ,Pass,66,13,79,J2EE ,Pass,36,12,48,J2EE AND SOFTWARE TESTING LABORATORY,Pass,65,15,80,PROJECT AND VIVA VOCE ,Pass,224,50,274
M1610820, College : 4233  -  PES COLLEGE OF CORPORATE SECRETARYSHIP  BELAGAVI,DISTI,73.84,SOFTWARE PRACTICES AND TESTING ,Pass,43,12,55,BUSINESS INTELLIGENCE ,Pass,47,15,62,J2EE ,Pass,43,17,60,J2EE AND SOFTWARE TESTING LABORATORY,Pass,68,14,82,PROJECT AND VIVA VOCE ,Pass,224,48,272
M1610821, College : 4233  -  PES COLLEGE OF CORPORATE SECRETARYSHIP  BELAGAVI,DISTI,70.65,SOFTWARE PRACTICES AND TESTING ,Pass,64,14,78,BUSINESS INTELLIGENCE ,Pass,54,15,69,J2EE ,Pass,41,18,59,J2EE AND SOFTWARE TESTING LABORATORY,Pass,69,16,85,PROJECT AND VIVA VOCE ,Pass,225,49,274
M1610822, College : 4233  -  PES COLLEGE OF CORPORATE SECRETARYSHIP  BELAGAVI,1ST C,63.86,SOFTWARE PRACTICES AND TESTING ,Pass,58,15,73,BUSINESS INTELLIGENCE ,Pass,47,10,57,J2EE ,Pass,32,14,46,J2EE AND SOFTWARE TESTING LABORATORY,Pass,64,14,78,PROJECT AND VIVA VOCE ,Pass,185,48,233
M1610823, College : 4233  -  PES COLLEGE OF CORPORATE SECRETARYSHIP  BELAGAVI,DISTI,73.95,SOFTWARE PRACTICES AND TESTING ,Pass,63,15,78,BUSINESS INTELLIGENCE ,Pass,58,18,76,J2EE ,Pass,45,18,63,J2EE AND SOFTWARE TESTING LABORATORY,Pass,70,15,85,PROJECT AND VIVA VOCE ,Pass,217,48,265
M1610824, College : 4233  -  PES COLLEGE OF CORPORATE SECRETARYSHIP  BELAGAVI,1ST C,68.43,SOFTWARE PRACTICES AND TESTING ,Pass,42,11,53,BUSINESS INTELLIGENCE ,Pass,42,11,53,J2EE ,Pass,34,10,44,J2EE AND SOFTWARE TESTING LABORATORY,Pass,73,14,87,PROJECT AND VIVA VOCE ,Pass,207,48,255
M1610825, College : 4233  -  PES COLLEGE OF CORPORATE SECRETARYSHIP  BELAGAVI,N.C.L,--   ,SOFTWARE PRACTICES AND TESTING ,Pass,43,11,54,BUSINESS INTELLIGENCE ,Pass,49,9,58,J2EE ,Pass,32,8,40,J2EE AND SOFTWARE TESTING LABORATORY,Pass,77,15,92,PROJECT AND VIVA VOCE ,Pass,207,48,255
M1610826, College : 4233  -  PES COLLEGE OF CORPORATE SECRETARYSHIP  BELAGAVI,1ST C,67.7,SOFTWARE PRACTICES AND TESTING ,Pass,43,9,52,BUSINESS INTELLIGENCE ,Pass,32,9,41,J2EE ,Pass,32,9,41,J2EE AND SOFTWARE TESTING LABORATORY,Pass,49,12,61,PROJECT AND VIVA VOCE ,Pass,189,42,231
M1610827, College : 4233  -  PES COLLEGE OF CORPORATE SECRETARYSHIP  BELAGAVI,1ST C,68.78,SOFTWARE PRACTICES AND TESTING ,Pass,49,13,62,BUSINESS INTELLIGENCE ,Pass,71,12,83,J2EE ,Pass,49,18,67,J2EE AND SOFTWARE TESTING LABORATORY,Pass,66,14,80,PROJECT AND VIVA VOCE ,Pass,224,45,269
M1610828, College : 4233  -  PES COLLEGE OF CORPORATE SECRETARYSHIP  BELAGAVI,DISTI,71,SOFTWARE PRACTICES AND TESTING ,Pass,55,10,65,BUSINESS INTELLIGENCE ,Pass,54,10,64,J2EE ,Pass,52,10,62,J2EE AND SOFTWARE TESTING LABORATORY,Pass,70,13,83,PROJECT AND VIVA VOCE ,Pass,213,49,262
M1610829, College : 4233  -  PES COLLEGE OF CORPORATE SECRETARYSHIP  BELAGAVI,N.C.L,--   ,SOFTWARE PRACTICES AND TESTING ,Pass,35,8,43,BUSINESS INTELLIGENCE ,Pass,43,8,51,J2EE ,Pass,41,8,49,J2EE AND SOFTWARE TESTING LABORATORY,Pass,50,4,54,PROJECT AND VIVA VOCE ,Pass,193,40,233
M1610830, College : 4233  -  PES COLLEGE OF CORPORATE SECRETARYSHIP  BELAGAVI,1ST C,62.7,SOFTWARE PRACTICES AND TESTING ,Pass,42,8,50,BUSINESS INTELLIGENCE ,Pass,34,8,42,J2EE ,Pass,32,9,41,J2EE AND SOFTWARE TESTING LABORATORY,Pass,57,5,62,PROJECT AND VIVA VOCE ,Pass,184,49,233
M1610831, College : 4233  -  PES COLLEGE OF CORPORATE SECRETARYSHIP  BELAGAVI,DISTI,83.65,SOFTWARE PRACTICES AND TESTING ,Pass,65,15,80,BUSINESS INTELLIGENCE ,Pass,58,19,77,J2EE ,Pass,64,16,80,J2EE AND SOFTWARE TESTING LABORATORY,Pass,68,11,79,PROJECT AND VIVA VOCE ,Pass,211,55,266
M1610832, College : 4233  -  PES COLLEGE OF CORPORATE SECRETARYSHIP  BELAGAVI,N.C.L,--   ,SOFTWARE PRACTICES AND TESTING ,Pass,40,15,55,BUSINESS INTELLIGENCE ,Pass,43,15,58,J2EE ,Pass,41,16,57,J2EE AND SOFTWARE TESTING LABORATORY,Pass,47,15,62,PROJECT AND VIVA VOCE ,Pass,235,58,293
M1610833, College : 4233  -  PES COLLEGE OF CORPORATE SECRETARYSHIP  BELAGAVI,DISTI,85,SOFTWARE PRACTICES AND TESTING ,Pass,70,16,86,BUSINESS INTELLIGENCE ,Pass,68,17,85,J2EE ,Pass,70,13,83,J2EE AND SOFTWARE TESTING LABORATORY,Pass,74,18,92,PROJECT AND VIVA VOCE ,Pass,227,50,277
M1610835, College : 4233  -  PES COLLEGE OF CORPORATE SECRETARYSHIP  BELAGAVI,DISTI,81.46,SOFTWARE PRACTICES AND TESTING ,Pass,71,14,85,BUSINESS INTELLIGENCE ,Pass,63,17,80,J2EE ,Pass,59,20,79,J2EE AND SOFTWARE TESTING LABORATORY,Pass,77,19,96,PROJECT AND VIVA VOCE ,Pass,209,49,258
M1610836, College : 4233  -  PES COLLEGE OF CORPORATE SECRETARYSHIP  BELAGAVI,FAIL,69,SOFTWARE PRACTICES AND TESTING ,Pass,43,9,52,BUSINESS INTELLIGENCE ,Pass,58,10,68,J2EE ,Fail,20,14,34,J2EE AND SOFTWARE TESTING LABORATORY,Pass,72,14,86,PROJECT AND VIVA VOCE ,Pass,198,45,243
M1610838, College : 4233  -  PES COLLEGE OF CORPORATE SECRETARYSHIP  BELAGAVI,DISTI,79.24,SOFTWARE PRACTICES AND TESTING ,Pass,61,18,79,BUSINESS INTELLIGENCE ,Pass,62,20,82,J2EE ,Pass,41,18,59,J2EE AND SOFTWARE TESTING LABORATORY,Pass,76,20,96,PROJECT AND VIVA VOCE ,Pass,150,60,210
M1610839, College : 4233  -  PES COLLEGE OF CORPORATE SECRETARYSHIP  BELAGAVI,N.C.L,--   ,SOFTWARE PRACTICES AND TESTING ,Pass,53,8,61,BUSINESS INTELLIGENCE ,Pass,49,9,58,J2EE ,Pass,40,9,49,J2EE AND SOFTWARE TESTING LABORATORY,Pass,37,4,41,PROJECT AND VIVA VOCE ,Pass,184,38,222
M1610840, College : 4233  -  PES COLLEGE OF CORPORATE SECRETARYSHIP  BELAGAVI,DISTI,78.95,SOFTWARE PRACTICES AND TESTING ,Pass,61,17,78,BUSINESS INTELLIGENCE ,Pass,54,16,70,J2EE ,Pass,48,14,62,J2EE AND SOFTWARE TESTING LABORATORY,Pass,69,19,88,PROJECT AND VIVA VOCE ,Pass,204,48,252
M1610841, College : 4233  -  PES COLLEGE OF CORPORATE SECRETARYSHIP  BELAGAVI,DISTI,78.54,SOFTWARE PRACTICES AND TESTING ,Pass,50,13,63,BUSINESS INTELLIGENCE ,Pass,56,15,71,J2EE ,Pass,56,16,72,J2EE AND SOFTWARE TESTING LABORATORY,Pass,75,17,92,PROJECT AND VIVA VOCE ,Pass,225,55,280
M1610843, College : 4233  -  PES COLLEGE OF CORPORATE SECRETARYSHIP  BELAGAVI,DISTI,81.95,SOFTWARE PRACTICES AND TESTING ,Pass,61,15,76,BUSINESS INTELLIGENCE ,Pass,49,19,68,J2EE ,Pass,60,19,79,J2EE AND SOFTWARE TESTING LABORATORY,Pass,73,17,90,PROJECT AND VIVA VOCE ,Pass,217,46,263
M1610844, College : 4233  -  PES COLLEGE OF CORPORATE SECRETARYSHIP  BELAGAVI,N.C.L,--   ,SOFTWARE PRACTICES AND TESTING ,Pass,50,10,60,BUSINESS INTELLIGENCE ,Pass,36,10,46,J2EE ,Pass,48,12,60,J2EE AND SOFTWARE TESTING LABORATORY,Pass,48,5,53,PROJECT AND VIVA VOCE ,Pass,194,42,236
M1610845, College : 4233  -  PES COLLEGE OF CORPORATE SECRETARYSHIP  BELAGAVI,FAIL,53.57,SOFTWARE PRACTICES AND TESTING ,Pass,40,8,48,BUSINESS INTELLIGENCE ,Fail,15,8,23,J2EE ,Fail,23,8,31,J2EE AND SOFTWARE TESTING LABORATORY,Pass,32,12,44,PROJECT AND VIVA VOCE ,Pass,189,40,229
M1610846, College : 4233  -  PES COLLEGE OF CORPORATE SECRETARYSHIP  BELAGAVI,DISTI,76.08,SOFTWARE PRACTICES AND TESTING ,Pass,64,13,77,BUSINESS INTELLIGENCE ,Pass,51,11,62,J2EE ,Pass,48,18,66,J2EE AND SOFTWARE TESTING LABORATORY,Pass,68,17,85,PROJECT AND VIVA VOCE ,Pass,185,48,233
M1610847, College : 4233  -  PES COLLEGE OF CORPORATE SECRETARYSHIP  BELAGAVI,DISTI,78.41,SOFTWARE PRACTICES AND TESTING ,Pass,67,15,82,BUSINESS INTELLIGENCE ,Pass,52,17,69,J2EE ,Pass,45,19,64,J2EE AND SOFTWARE TESTING LABORATORY,Pass,71,14,85,PROJECT AND VIVA VOCE ,Pass,225,51,276
M1610848, College : 4233  -  PES COLLEGE OF CORPORATE SECRETARYSHIP  BELAGAVI,DISTI,71.73,SOFTWARE PRACTICES AND TESTING ,Pass,50,12,62,BUSINESS INTELLIGENCE ,Pass,47,13,60,J2EE ,Pass,32,18,50,J2EE AND SOFTWARE TESTING LABORATORY,Pass,65,16,81,PROJECT AND VIVA VOCE ,Pass,224,49,273
M1610849, College : 4233  -  PES COLLEGE OF CORPORATE SECRETARYSHIP  BELAGAVI,1ST C,63.92,SOFTWARE PRACTICES AND TESTING ,Pass,41,12,53,BUSINESS INTELLIGENCE ,Pass,41,15,56,J2EE ,Pass,32,13,45,J2EE AND SOFTWARE TESTING LABORATORY,Pass,44,6,50,PROJECT AND VIVA VOCE ,Pass,213,49,262
M1610850, College : 4233  -  PES COLLEGE OF CORPORATE SECRETARYSHIP  BELAGAVI,FAIL,3.71,SOFTWARE PRACTICES AND TESTING ,Fail,Ab.,4,4,BUSINESS INTELLIGENCE ,Fail,Ab.,4,4,J2EE ,Fail,Ab.,4,4,J2EE AND SOFTWARE TESTING LABORATORY,Fail,Ab.,4,4,PROJECT AND VIVA VOCE ,Fail,Ab.,10,10
M1610851, College : 4233  -  PES COLLEGE OF CORPORATE SECRETARYSHIP  BELAGAVI,DISTI,88.49,SOFTWARE PRACTICES AND TESTING ,Pass,59,18,77,BUSINESS INTELLIGENCE ,Pass,64,19,83,J2EE ,Pass,68,18,86,J2EE AND SOFTWARE TESTING LABORATORY,Pass,76,18,94,PROJECT AND VIVA VOCE ,Pass,225,56,281
M1610852, College : 4233  -  PES COLLEGE OF CORPORATE SECRETARYSHIP  BELAGAVI,DISTI,76.89,SOFTWARE PRACTICES AND TESTING ,Pass,57,14,71,BUSINESS INTELLIGENCE ,Pass,75,17,92,J2EE ,Pass,56,17,73,J2EE AND SOFTWARE TESTING LABORATORY,Pass,68,8,76,PROJECT AND VIVA VOCE ,Pass,215,53,268
M1610853, College : 4233  -  PES COLLEGE OF CORPORATE SECRETARYSHIP  BELAGAVI,1ST C,68.95,SOFTWARE PRACTICES AND TESTING ,Pass,43,17,60,BUSINESS INTELLIGENCE ,Pass,69,19,88,J2EE ,Pass,37,17,54,J2EE AND SOFTWARE TESTING LABORATORY,Pass,46,16,62,PROJECT AND VIVA VOCE ,Pass,214,52,266
M1610854, College : 4233  -  PES COLLEGE OF CORPORATE SECRETARYSHIP  BELAGAVI,DISTI,91.11,SOFTWARE PRACTICES AND TESTING ,Pass,67,20,87,BUSINESS INTELLIGENCE ,Pass,72,20,92,J2EE ,Pass,69,20,89,J2EE AND SOFTWARE TESTING LABORATORY,Pass,78,20,98,PROJECT AND VIVA VOCE ,Pass,238,59,297
M1610855, College : 4233  -  PES COLLEGE OF CORPORATE SECRETARYSHIP  BELAGAVI,DISTI,89,SOFTWARE PRACTICES AND TESTING ,Pass,65,19,84,BUSINESS INTELLIGENCE ,Pass,71,20,91,J2EE ,Pass,54,20,74,J2EE AND SOFTWARE TESTING LABORATORY,Pass,79,19,98,PROJECT AND VIVA VOCE ,Pass,238,56,294
M1610856, College : 4233  -  PES COLLEGE OF CORPORATE SECRETARYSHIP  BELAGAVI,DISTI,76.22,SOFTWARE PRACTICES AND TESTING ,Pass,62,15,77,BUSINESS INTELLIGENCE ,Pass,67,18,85,J2EE ,Pass,38,17,55,J2EE AND SOFTWARE TESTING LABORATORY,Pass,74,16,90,PROJECT AND VIVA VOCE ,Pass,205,49,254
M1610857, College : 4233  -  PES COLLEGE OF CORPORATE SECRETARYSHIP  BELAGAVI,FAIL,40.86,SOFTWARE PRACTICES AND TESTING ,Pass,47,12,59,BUSINESS INTELLIGENCE ,Pass,47,13,60,J2EE ,Pass,35,13,48,J2EE AND SOFTWARE TESTING LABORATORY,Pass,32,11,43,PROJECT AND VIVA VOCE ,Fail,50,26,76
M1610858, College : 4233  -  PES COLLEGE OF CORPORATE SECRETARYSHIP  BELAGAVI,DISTI,86.95,SOFTWARE PRACTICES AND TESTING ,Pass,70,12,82,BUSINESS INTELLIGENCE ,Pass,73,18,91,J2EE ,Pass,70,18,88,J2EE AND SOFTWARE TESTING LABORATORY,Pass,75,16,91,PROJECT AND VIVA VOCE ,Pass,215,50,265
M1610859, College : 4233  -  PES COLLEGE OF CORPORATE SECRETARYSHIP  BELAGAVI,DISTI,91.49,SOFTWARE PRACTICES AND TESTING ,Pass,57,19,76,BUSINESS INTELLIGENCE ,Pass,73,20,93,J2EE ,Pass,70,20,90,J2EE AND SOFTWARE TESTING LABORATORY,Pass,80,19,99,PROJECT AND VIVA VOCE ,Pass,238,59,297
M1610860, College : 4233  -  PES COLLEGE OF CORPORATE SECRETARYSHIP  BELAGAVI,1ST C,65.24,SOFTWARE PRACTICES AND TESTING ,Pass,32,11,43,BUSINESS INTELLIGENCE ,Pass,51,13,64,J2EE ,Pass,32,16,48,J2EE AND SOFTWARE TESTING LABORATORY,Pass,64,15,79,PROJECT AND VIVA VOCE ,Pass,180,48,228
M1610862, College : 4233  -  PES COLLEGE OF CORPORATE SECRETARYSHIP  BELAGAVI,DISTI,72.35,SOFTWARE PRACTICES AND TESTING ,Pass,52,16,68,BUSINESS INTELLIGENCE ,Pass,62,16,78,J2EE ,Pass,51,17,68,J2EE AND SOFTWARE TESTING LABORATORY,Pass,67,18,85,PROJECT AND VIVA VOCE ,Pass,209,50,259
M1610863, College : 4233  -  PES COLLEGE OF CORPORATE SECRETARYSHIP  BELAGAVI,FAIL,57.43,SOFTWARE PRACTICES AND TESTING ,Pass,34,9,43,BUSINESS INTELLIGENCE ,Pass,43,10,53,J2EE ,Fail,19,9,28,J2EE AND SOFTWARE TESTING LABORATORY,Pass,59,4,63,PROJECT AND VIVA VOCE ,Pass,174,41,215
M1610864, College : 4233  -  PES COLLEGE OF CORPORATE SECRETARYSHIP  BELAGAVI,N.C.L,--   ,SOFTWARE PRACTICES AND TESTING ,Pass,34,8,42,BUSINESS INTELLIGENCE ,Pass,40,12,52,J2EE ,Pass,32,11,43,J2EE AND SOFTWARE TESTING LABORATORY,Pass,51,4,55,PROJECT AND VIVA VOCE ,Pass,211,48,259
M1610865, College : 4233  -  PES COLLEGE OF CORPORATE SECRETARYSHIP  BELAGAVI,2ND C,57.49,SOFTWARE PRACTICES AND TESTING ,Pass,34,8,42,BUSINESS INTELLIGENCE ,Pass,32,15,47,J2EE ,Pass,40,9,49,J2EE AND SOFTWARE TESTING LABORATORY,Pass,59,5,64,PROJECT AND VIVA VOCE ,Pass,175,42,217
M1610866, College : 4233  -  PES COLLEGE OF CORPORATE SECRETARYSHIP  BELAGAVI,DISTI,80.92,SOFTWARE PRACTICES AND TESTING ,Pass,68,14,82,BUSINESS INTELLIGENCE ,Pass,60,17,77,J2EE ,Pass,52,19,71,J2EE AND SOFTWARE TESTING LABORATORY,Pass,72,16,88,PROJECT AND VIVA VOCE ,Pass,201,49,250
M1610867, College : 4233  -  PES COLLEGE OF CORPORATE SECRETARYSHIP  BELAGAVI,DISTI,85.19,SOFTWARE PRACTICES AND TESTING ,Pass,68,17,85,BUSINESS INTELLIGENCE ,Pass,53,17,70,J2EE ,Pass,53,20,73,J2EE AND SOFTWARE TESTING LABORATORY,Pass,74,19,93,PROJECT AND VIVA VOCE ,Pass,238,59,297
M1610868, College : 4233  -  PES COLLEGE OF CORPORATE SECRETARYSHIP  BELAGAVI,DISTI,73.24,SOFTWARE PRACTICES AND TESTING ,Pass,40,10,50,BUSINESS INTELLIGENCE ,Pass,49,13,62,J2EE ,Pass,46,11,57,J2EE AND SOFTWARE TESTING LABORATORY,Pass,64,14,78,PROJECT AND VIVA VOCE ,Pass,211,40,251
M1610869, College : 4233  -  PES COLLEGE OF CORPORATE SECRETARYSHIP  BELAGAVI,DISTI,86.76,SOFTWARE PRACTICES AND TESTING ,Pass,73,17,90,BUSINESS INTELLIGENCE ,Pass,77,17,94,J2EE ,Pass,75,20,95,J2EE AND SOFTWARE TESTING LABORATORY,Pass,76,18,94,PROJECT AND VIVA VOCE ,Pass,238,59,297
M1610870, College : 4233  -  PES COLLEGE OF CORPORATE SECRETARYSHIP  BELAGAVI,1ST C,64.27,SOFTWARE PRACTICES AND TESTING ,Pass,55,10,65,BUSINESS INTELLIGENCE ,Pass,53,11,64,J2EE ,Pass,55,15,70,J2EE AND SOFTWARE TESTING LABORATORY,Pass,69,12,81,PROJECT AND VIVA VOCE ,Pass,199,41,240
M1610871, College : 4233  -  PES COLLEGE OF CORPORATE SECRETARYSHIP  BELAGAVI,N.C.L,--   ,SOFTWARE PRACTICES AND TESTING ,Pass,46,9,55,BUSINESS INTELLIGENCE ,Pass,48,10,58,J2EE ,Pass,32,10,42,J2EE AND SOFTWARE TESTING LABORATORY,Pass,32,11,43,PROJECT AND VIVA VOCE ,Pass,209,48,257
M1610872, College : 4233  -  PES COLLEGE OF CORPORATE SECRETARYSHIP  BELAGAVI,FAIL,64.57,SOFTWARE PRACTICES AND TESTING ,Pass,35,11,46,BUSINESS INTELLIGENCE ,Pass,32,12,44,J2EE ,Fail,20,12,32,J2EE AND SOFTWARE TESTING LABORATORY,Pass,66,12,78,PROJECT AND VIVA VOCE ,Pass,209,43,252
M1610873, College : 4233  -  PES COLLEGE OF CORPORATE SECRETARYSHIP  BELAGAVI,FAIL,52.57,SOFTWARE PRACTICES AND TESTING ,Pass,32,8,40,BUSINESS INTELLIGENCE ,Pass,32,12,44,J2EE ,Fail,20,10,30,J2EE AND SOFTWARE TESTING LABORATORY,Pass,42,8,50,PROJECT AND VIVA VOCE ,Pass,170,34,204
M1610874, College : 4233  -  PES COLLEGE OF CORPORATE SECRETARYSHIP  BELAGAVI,1ST C,64,SOFTWARE PRACTICES AND TESTING ,Pass,50,9,59,BUSINESS INTELLIGENCE ,Pass,57,11,68,J2EE ,Pass,42,17,59,J2EE AND SOFTWARE TESTING LABORATORY,Pass,70,13,83,PROJECT AND VIVA VOCE ,Pass,184,49,233
M1611001, College : 4241  -  JAIN COLLEGE OF BBA  BCA AND COMMERCE  BELAGAVI,N.C.L,--   ,SOFTWARE PRACTICES AND TESTING ,Pass,42,9,51,BUSINESS INTELLIGENCE ,Pass,33,9,42,J2EE ,Pass,32,9,41,J2EE AND SOFTWARE TESTING LABORATORY,Pass,32,13,45,PROJECT AND VIVA VOCE ,Pass,130,40,170
M1611001, College : 4241  -  JAIN COLLEGE OF BBA  BCA AND COMMERCE  BELAGAVI,N.C.L,--   ,SOFTWARE PRACTICES AND TESTING ,Pass,42,9,51,BUSINESS INTELLIGENCE ,Pass,33,9,42,J2EE ,Pass,32,9,41,J2EE AND SOFTWARE TESTING LABORATORY,Pass,32,13,45,PROJECT AND VIVA VOCE ,Pass,130,40,170
M1611002, College : 4241  -  JAIN COLLEGE OF BBA  BCA AND COMMERCE  BELAGAVI,N.C.L,--   ,SOFTWARE PRACTICES AND TESTING ,Pass,33,9,42,BUSINESS INTELLIGENCE ,Pass,32,9,41,J2EE ,Pass,35,9,44,J2EE AND SOFTWARE TESTING LABORATORY,Pass,32,13,45,PROJECT AND VIVA VOCE ,Pass,130,45,175
M1611003, College : 4241  -  JAIN COLLEGE OF BBA  BCA AND COMMERCE  BELAGAVI,N.C.L,--   ,SOFTWARE PRACTICES AND TESTING ,Pass,33,11,44,BUSINESS INTELLIGENCE ,Pass,47,11,58,J2EE ,Pass,34,12,46,J2EE AND SOFTWARE TESTING LABORATORY,Pass,54,18,72,PROJECT AND VIVA VOCE ,Pass,150,47,197
M1611004, College : 4241  -  JAIN COLLEGE OF BBA  BCA AND COMMERCE  BELAGAVI,N.C.L,--   ,SOFTWARE PRACTICES AND TESTING ,Pass,43,14,57,BUSINESS INTELLIGENCE ,Pass,42,14,56,J2EE ,Pass,41,15,56,J2EE AND SOFTWARE TESTING LABORATORY,Pass,32,18,50,PROJECT AND VIVA VOCE ,Pass,160,47,207
M1611005, College : 4241  -  JAIN COLLEGE OF BBA  BCA AND COMMERCE  BELAGAVI,DISTI,71.59,SOFTWARE PRACTICES AND TESTING ,Pass,57,13,70,BUSINESS INTELLIGENCE ,Pass,58,13,71,J2EE ,Pass,55,14,69,J2EE AND SOFTWARE TESTING LABORATORY,Pass,52,19,71,PROJECT AND VIVA VOCE ,Pass,200,55,255
M1611006, College : 4241  -  JAIN COLLEGE OF BBA  BCA AND COMMERCE  BELAGAVI,FAIL,46.14,SOFTWARE PRACTICES AND TESTING ,Pass,32,9,41,BUSINESS INTELLIGENCE ,Fail,15,9,24,J2EE ,Pass,32,9,41,J2EE AND SOFTWARE TESTING LABORATORY,Pass,32,13,45,PROJECT AND VIVA VOCE ,Pass,130,42,172
M1611007, College : 4241  -  JAIN COLLEGE OF BBA  BCA AND COMMERCE  BELAGAVI,N.C.L,--   ,SOFTWARE PRACTICES AND TESTING ,Pass,32,11,43,BUSINESS INTELLIGENCE ,Pass,48,12,60,J2EE ,Pass,43,12,55,J2EE AND SOFTWARE TESTING LABORATORY,Pass,32,13,45,PROJECT AND VIVA VOCE ,Pass,130,42,172
M1611008, College : 4241  -  JAIN COLLEGE OF BBA  BCA AND COMMERCE  BELAGAVI,DISTI,71.57,SOFTWARE PRACTICES AND TESTING ,Pass,56,14,70,BUSINESS INTELLIGENCE ,Pass,59,15,74,J2EE ,Pass,45,15,60,J2EE AND SOFTWARE TESTING LABORATORY,Pass,67,18,85,PROJECT AND VIVA VOCE ,Pass,180,47,227
M1611010, College : 4241  -  JAIN COLLEGE OF BBA  BCA AND COMMERCE  BELAGAVI,DISTI,73.78,SOFTWARE PRACTICES AND TESTING ,Pass,55,14,69,BUSINESS INTELLIGENCE ,Pass,54,16,70,J2EE ,Pass,44,16,60,J2EE AND SOFTWARE TESTING LABORATORY,Pass,34,16,50,PROJECT AND VIVA VOCE ,Pass,180,49,229
M1611011, College : 4241  -  JAIN COLLEGE OF BBA  BCA AND COMMERCE  BELAGAVI,DISTI,87.35,SOFTWARE PRACTICES AND TESTING ,Pass,61,20,81,BUSINESS INTELLIGENCE ,Pass,66,20,86,J2EE ,Pass,51,20,71,J2EE AND SOFTWARE TESTING LABORATORY,Pass,74,20,94,PROJECT AND VIVA VOCE ,Pass,220,58,278
M1611012, College : 4241  -  JAIN COLLEGE OF BBA  BCA AND COMMERCE  BELAGAVI,N.C.L,--   ,SOFTWARE PRACTICES AND TESTING ,Pass,34,16,50,BUSINESS INTELLIGENCE ,Pass,49,17,66,J2EE ,Pass,46,16,62,J2EE AND SOFTWARE TESTING LABORATORY,Pass,32,16,48,PROJECT AND VIVA VOCE ,Pass,170,42,212
M1611013, College : 4241  -  JAIN COLLEGE OF BBA  BCA AND COMMERCE  BELAGAVI,DISTI,84.68,SOFTWARE PRACTICES AND TESTING ,Pass,62,20,82,BUSINESS INTELLIGENCE ,Pass,77,20,97,J2EE ,Pass,49,20,69,J2EE AND SOFTWARE TESTING LABORATORY,Pass,70,20,90,PROJECT AND VIVA VOCE ,Pass,200,59,259
M1611014, College : 4241  -  JAIN COLLEGE OF BBA  BCA AND COMMERCE  BELAGAVI,N.C.L,--   ,SOFTWARE PRACTICES AND TESTING ,Pass,36,13,49,BUSINESS INTELLIGENCE ,Pass,45,14,59,J2EE ,Pass,44,12,56,J2EE AND SOFTWARE TESTING LABORATORY,Pass,34,13,47,PROJECT AND VIVA VOCE ,Pass,180,51,231
M1611015, College : 4241  -  JAIN COLLEGE OF BBA  BCA AND COMMERCE  BELAGAVI,FAIL,46.14,SOFTWARE PRACTICES AND TESTING ,Fail,9,11,20,BUSINESS INTELLIGENCE ,Pass,32,13,45,J2EE ,Pass,39,12,51,J2EE AND SOFTWARE TESTING LABORATORY,Pass,32,13,45,PROJECT AND VIVA VOCE ,Pass,120,42,162
M1611016, College : 4241  -  JAIN COLLEGE OF BBA  BCA AND COMMERCE  BELAGAVI,DISTI,70.03,SOFTWARE PRACTICES AND TESTING ,Pass,48,13,61,BUSINESS INTELLIGENCE ,Pass,41,14,55,J2EE ,Pass,39,14,53,J2EE AND SOFTWARE TESTING LABORATORY,Pass,44,18,62,PROJECT AND VIVA VOCE ,Pass,210,54,264
M1611017, College : 4241  -  JAIN COLLEGE OF BBA  BCA AND COMMERCE  BELAGAVI,N.C.L,--   ,SOFTWARE PRACTICES AND TESTING ,Pass,45,12,57,BUSINESS INTELLIGENCE ,Pass,39,12,51,J2EE ,Pass,36,12,48,J2EE AND SOFTWARE TESTING LABORATORY,Pass,53,13,66,PROJECT AND VIVA VOCE ,Pass,140,47,187
M1611018, College : 4241  -  JAIN COLLEGE OF BBA  BCA AND COMMERCE  BELAGAVI,DISTI,81.62,SOFTWARE PRACTICES AND TESTING ,Pass,63,17,80,BUSINESS INTELLIGENCE ,Pass,49,19,68,J2EE ,Pass,54,18,72,J2EE AND SOFTWARE TESTING LABORATORY,Pass,62,18,80,PROJECT AND VIVA VOCE ,Pass,200,56,256
M1611019, College : 4241  -  JAIN COLLEGE OF BBA  BCA AND COMMERCE  BELAGAVI,N.C.L,--   ,SOFTWARE PRACTICES AND TESTING ,Pass,59,15,74,BUSINESS INTELLIGENCE ,Pass,51,16,67,J2EE ,Pass,43,17,60,J2EE AND SOFTWARE TESTING LABORATORY,Pass,68,18,86,PROJECT AND VIVA VOCE ,Pass,230,60,290
M1611020, College : 4241  -  JAIN COLLEGE OF BBA  BCA AND COMMERCE  BELAGAVI,N.C.L,--   ,SOFTWARE PRACTICES AND TESTING ,Pass,65,18,83,BUSINESS INTELLIGENCE ,Pass,57,19,76,J2EE ,Pass,41,17,58,J2EE AND SOFTWARE TESTING LABORATORY,Pass,38,18,56,PROJECT AND VIVA VOCE ,Pass,120,47,167
M1611021, College : 4241  -  JAIN COLLEGE OF BBA  BCA AND COMMERCE  BELAGAVI,DISTI,72.86,SOFTWARE PRACTICES AND TESTING ,Pass,58,18,76,BUSINESS INTELLIGENCE ,Pass,58,19,77,J2EE ,Pass,42,17,59,J2EE AND SOFTWARE TESTING LABORATORY,Pass,32,20,52,PROJECT AND VIVA VOCE ,Pass,180,51,231
M1611022, College : 4241  -  JAIN COLLEGE OF BBA  BCA AND COMMERCE  BELAGAVI,DISTI,72.57,SOFTWARE PRACTICES AND TESTING ,Pass,60,17,77,BUSINESS INTELLIGENCE ,Pass,54,16,70,J2EE ,Pass,46,15,61,J2EE AND SOFTWARE TESTING LABORATORY,Pass,60,18,78,PROJECT AND VIVA VOCE ,Pass,190,44,234
M1611023, College : 4241  -  JAIN COLLEGE OF BBA  BCA AND COMMERCE  BELAGAVI,DISTI,81.16,SOFTWARE PRACTICES AND TESTING ,Pass,64,19,83,BUSINESS INTELLIGENCE ,Pass,73,20,93,J2EE ,Pass,50,20,70,J2EE AND SOFTWARE TESTING LABORATORY,Pass,76,20,96,PROJECT AND VIVA VOCE ,Pass,200,60,260
M1611024, College : 4241  -  JAIN COLLEGE OF BBA  BCA AND COMMERCE  BELAGAVI,2ND C,54.84,SOFTWARE PRACTICES AND TESTING ,Pass,55,16,71,BUSINESS INTELLIGENCE ,Pass,61,18,79,J2EE ,Pass,42,16,58,J2EE AND SOFTWARE TESTING LABORATORY,Pass,32,16,48,PROJECT AND VIVA VOCE ,Pass,170,47,217
M1611025, College : 4241  -  JAIN COLLEGE OF BBA  BCA AND COMMERCE  BELAGAVI,DISTI,91.24,SOFTWARE PRACTICES AND TESTING ,Pass,64,20,84,BUSINESS INTELLIGENCE ,Pass,75,20,95,J2EE ,Pass,78,20,98,J2EE AND SOFTWARE TESTING LABORATORY,Pass,74,20,94,PROJECT AND VIVA VOCE ,Pass,230,60,290
M1611026, College : 4241  -  JAIN COLLEGE OF BBA  BCA AND COMMERCE  BELAGAVI,N.C.L,--   ,SOFTWARE PRACTICES AND TESTING ,Pass,56,16,72,BUSINESS INTELLIGENCE ,Pass,39,19,58,J2EE ,Pass,48,18,66,J2EE AND SOFTWARE TESTING LABORATORY,Pass,72,19,91,PROJECT AND VIVA VOCE ,Pass,212,53,265
M1611027, College : 4241  -  JAIN COLLEGE OF BBA  BCA AND COMMERCE  BELAGAVI,DISTI,77.38,SOFTWARE PRACTICES AND TESTING ,Pass,54,19,73,BUSINESS INTELLIGENCE ,Pass,47,20,67,J2EE ,Pass,32,20,52,J2EE AND SOFTWARE TESTING LABORATORY,Pass,54,20,74,PROJECT AND VIVA VOCE ,Pass,200,56,256
M1611028, College : 4241  -  JAIN COLLEGE OF BBA  BCA AND COMMERCE  BELAGAVI,DISTI,76.97,SOFTWARE PRACTICES AND TESTING ,Pass,52,17,69,BUSINESS INTELLIGENCE ,Pass,60,19,79,J2EE ,Pass,41,18,59,J2EE AND SOFTWARE TESTING LABORATORY,Pass,58,20,78,PROJECT AND VIVA VOCE ,Pass,200,56,256
M1611029, College : 4241  -  JAIN COLLEGE OF BBA  BCA AND COMMERCE  BELAGAVI,N.C.L,--   ,SOFTWARE PRACTICES AND TESTING ,Pass,37,17,54,BUSINESS INTELLIGENCE ,Pass,32,17,49,J2EE ,Pass,32,16,48,J2EE AND SOFTWARE TESTING LABORATORY,Pass,51,16,67,PROJECT AND VIVA VOCE ,Pass,150,47,197
M1611030, College : 4241  -  JAIN COLLEGE OF BBA  BCA AND COMMERCE  BELAGAVI,DISTI,86.38,SOFTWARE PRACTICES AND TESTING ,Pass,67,20,87,BUSINESS INTELLIGENCE ,Pass,62,19,81,J2EE ,Pass,46,20,66,J2EE AND SOFTWARE TESTING LABORATORY,Pass,72,20,92,PROJECT AND VIVA VOCE ,Pass,220,58,278
M1611032, College : 4241  -  JAIN COLLEGE OF BBA  BCA AND COMMERCE  BELAGAVI,FAIL,53.86,SOFTWARE PRACTICES AND TESTING ,Pass,34,15,49,BUSINESS INTELLIGENCE ,Pass,48,16,64,J2EE ,Pass,42,16,58,J2EE AND SOFTWARE TESTING LABORATORY,Fail,8,16,24,PROJECT AND VIVA VOCE ,Pass,140,42,182
M1611033, College : 4241  -  JAIN COLLEGE OF BBA  BCA AND COMMERCE  BELAGAVI,N.C.L,--   ,SOFTWARE PRACTICES AND TESTING ,Pass,34,9,43,BUSINESS INTELLIGENCE ,Pass,56,9,65,J2EE ,Pass,45,9,54,J2EE AND SOFTWARE TESTING LABORATORY,Pass,52,15,67,PROJECT AND VIVA VOCE ,Pass,210,54,264
M1611034, College : 4241  -  JAIN COLLEGE OF BBA  BCA AND COMMERCE  BELAGAVI,DISTI,78.08,SOFTWARE PRACTICES AND TESTING ,Pass,60,17,77,BUSINESS INTELLIGENCE ,Pass,61,19,80,J2EE ,Pass,41,18,59,J2EE AND SOFTWARE TESTING LABORATORY,Pass,67,18,85,PROJECT AND VIVA VOCE ,Pass,220,60,280
M1611036, College : 4241  -  JAIN COLLEGE OF BBA  BCA AND COMMERCE  BELAGAVI,FAIL,41.57,SOFTWARE PRACTICES AND TESTING ,Fail,18,9,27,BUSINESS INTELLIGENCE ,Pass,32,9,41,J2EE ,Fail,22,9,31,J2EE AND SOFTWARE TESTING LABORATORY,Fail,9,13,22,PROJECT AND VIVA VOCE ,Pass,130,40,170
M1611037, College : 4241  -  JAIN COLLEGE OF BBA  BCA AND COMMERCE  BELAGAVI,DISTI,77.49,SOFTWARE PRACTICES AND TESTING ,Pass,55,18,73,BUSINESS INTELLIGENCE ,Pass,49,18,67,J2EE ,Pass,36,20,56,J2EE AND SOFTWARE TESTING LABORATORY,Pass,67,20,87,PROJECT AND VIVA VOCE ,Pass,190,56,246
M1611038, College : 4241  -  JAIN COLLEGE OF BBA  BCA AND COMMERCE  BELAGAVI,1ST C,64.41,SOFTWARE PRACTICES AND TESTING ,Pass,38,16,54,BUSINESS INTELLIGENCE ,Pass,50,16,66,J2EE ,Pass,33,17,50,J2EE AND SOFTWARE TESTING LABORATORY,Pass,38,19,57,PROJECT AND VIVA VOCE ,Pass,190,53,243
M1611039, College : 4241  -  JAIN COLLEGE OF BBA  BCA AND COMMERCE  BELAGAVI,FAIL,52.14,SOFTWARE PRACTICES AND TESTING ,Pass,34,12,46,BUSINESS INTELLIGENCE ,Pass,44,13,57,J2EE ,Fail,24,11,35,J2EE AND SOFTWARE TESTING LABORATORY,Pass,32,13,45,PROJECT AND VIVA VOCE ,Pass,140,42,182
M1611040, College : 4241  -  JAIN COLLEGE OF BBA  BCA AND COMMERCE  BELAGAVI,FAIL,56.14,SOFTWARE PRACTICES AND TESTING ,Pass,37,11,48,BUSINESS INTELLIGENCE ,Pass,34,11,45,J2EE ,Fail,18,12,30,J2EE AND SOFTWARE TESTING LABORATORY,Pass,32,14,46,PROJECT AND VIVA VOCE ,Pass,180,44,224
M1611041, College : 4241  -  JAIN COLLEGE OF BBA  BCA AND COMMERCE  BELAGAVI,FAIL,51.14,SOFTWARE PRACTICES AND TESTING ,Pass,33,12,45,BUSINESS INTELLIGENCE ,Pass,32,12,44,J2EE ,Fail,20,12,32,J2EE AND SOFTWARE TESTING LABORATORY,Pass,32,13,45,PROJECT AND VIVA VOCE ,Pass,150,42,192
M1611042, College : 4241  -  JAIN COLLEGE OF BBA  BCA AND COMMERCE  BELAGAVI,N.C.L,--   ,SOFTWARE PRACTICES AND TESTING ,Pass,61,16,77,BUSINESS INTELLIGENCE ,Pass,43,17,60,J2EE ,Pass,32,15,47,J2EE AND SOFTWARE TESTING LABORATORY,Pass,54,18,72,PROJECT AND VIVA VOCE ,Pass,120,47,167
M1611043, College : 4241  -  JAIN COLLEGE OF BBA  BCA AND COMMERCE  BELAGAVI,DISTI,71.03,SOFTWARE PRACTICES AND TESTING ,Pass,42,18,60,BUSINESS INTELLIGENCE ,Pass,41,17,58,J2EE ,Pass,32,19,51,J2EE AND SOFTWARE TESTING LABORATORY,Pass,56,19,75,PROJECT AND VIVA VOCE ,Pass,210,60,270
M1611044, College : 4241  -  JAIN COLLEGE OF BBA  BCA AND COMMERCE  BELAGAVI,N.C.L,--   ,SOFTWARE PRACTICES AND TESTING ,Pass,57,12,69,BUSINESS INTELLIGENCE ,Pass,32,12,44,J2EE ,Pass,37,13,50,J2EE AND SOFTWARE TESTING LABORATORY,Pass,60,18,78,PROJECT AND VIVA VOCE ,Pass,180,47,227
M1611045, College : 4241  -  JAIN COLLEGE OF BBA  BCA AND COMMERCE  BELAGAVI,DISTI,71.73,SOFTWARE PRACTICES AND TESTING ,Pass,53,15,68,BUSINESS INTELLIGENCE ,Pass,39,16,55,J2EE ,Pass,36,14,50,J2EE AND SOFTWARE TESTING LABORATORY,Pass,55,16,71,PROJECT AND VIVA VOCE ,Pass,180,47,227
M1611046, College : 4241  -  JAIN COLLEGE OF BBA  BCA AND COMMERCE  BELAGAVI,N.C.L,--   ,SOFTWARE PRACTICES AND TESTING ,Pass,42,9,51,BUSINESS INTELLIGENCE ,Pass,54,9,63,J2EE ,Pass,34,9,43,J2EE AND SOFTWARE TESTING LABORATORY,Pass,32,13,45,PROJECT AND VIVA VOCE ,Pass,160,42,202
M1611047, College : 4241  -  JAIN COLLEGE OF BBA  BCA AND COMMERCE  BELAGAVI,DISTI,75.59,SOFTWARE PRACTICES AND TESTING ,Pass,52,13,65,BUSINESS INTELLIGENCE ,Pass,54,12,66,J2EE ,Pass,41,14,55,J2EE AND SOFTWARE TESTING LABORATORY,Pass,32,18,50,PROJECT AND VIVA VOCE ,Pass,190,56,246
M1611049, College : 4241  -  JAIN COLLEGE OF BBA  BCA AND COMMERCE  BELAGAVI,DISTI,70.81,SOFTWARE PRACTICES AND TESTING ,Pass,50,15,65,BUSINESS INTELLIGENCE ,Pass,55,17,72,J2EE ,Pass,36,16,52,J2EE AND SOFTWARE TESTING LABORATORY,Pass,60,17,77,PROJECT AND VIVA VOCE ,Pass,200,56,256
M1611050, College : 4241  -  JAIN COLLEGE OF BBA  BCA AND COMMERCE  BELAGAVI,2ND C,55.68,SOFTWARE PRACTICES AND TESTING ,Pass,45,13,58,BUSINESS INTELLIGENCE ,Pass,43,14,57,J2EE ,Pass,32,14,46,J2EE AND SOFTWARE TESTING LABORATORY,Pass,32,15,47,PROJECT AND VIVA VOCE ,Pass,170,47,217
M1611051, College : 4241  -  JAIN COLLEGE OF BBA  BCA AND COMMERCE  BELAGAVI,1ST C,62.38,SOFTWARE PRACTICES AND TESTING ,Pass,53,13,66,BUSINESS INTELLIGENCE ,Pass,65,13,78,J2EE ,Pass,39,14,53,J2EE AND SOFTWARE TESTING LABORATORY,Pass,37,16,53,PROJECT AND VIVA VOCE ,Pass,190,51,241
M1611052, College : 4241  -  JAIN COLLEGE OF BBA  BCA AND COMMERCE  BELAGAVI,DISTI,84.86,SOFTWARE PRACTICES AND TESTING ,Pass,65,19,84,BUSINESS INTELLIGENCE ,Pass,75,20,95,J2EE ,Pass,51,20,71,J2EE AND SOFTWARE TESTING LABORATORY,Pass,77,20,97,PROJECT AND VIVA VOCE ,Pass,230,60,290
M1611053, College : 4241  -  JAIN COLLEGE OF BBA  BCA AND COMMERCE  BELAGAVI,FAIL,63.29,SOFTWARE PRACTICES AND TESTING ,Pass,43,15,58,BUSINESS INTELLIGENCE ,Pass,50,17,67,J2EE ,Fail,21,16,37,J2EE AND SOFTWARE TESTING LABORATORY,Pass,36,18,54,PROJECT AND VIVA VOCE ,Pass,180,47,227
M1611054, College : 4241  -  JAIN COLLEGE OF BBA  BCA AND COMMERCE  BELAGAVI,FAIL,49.14,SOFTWARE PRACTICES AND TESTING ,Pass,32,13,45,BUSINESS INTELLIGENCE ,Pass,42,12,54,J2EE ,Fail,18,12,30,J2EE AND SOFTWARE TESTING LABORATORY,Pass,32,13,45,PROJECT AND VIVA VOCE ,Pass,130,40,170
M1611055, College : 4241  -  JAIN COLLEGE OF BBA  BCA AND COMMERCE  BELAGAVI,FAIL,65.43,SOFTWARE PRACTICES AND TESTING ,Pass,39,15,54,BUSINESS INTELLIGENCE ,Pass,47,14,61,J2EE ,Fail,18,16,34,J2EE AND SOFTWARE TESTING LABORATORY,Pass,43,17,60,PROJECT AND VIVA VOCE ,Pass,200,49,249
M1611056, College : 4241  -  JAIN COLLEGE OF BBA  BCA AND COMMERCE  BELAGAVI,FAIL,66.71,SOFTWARE PRACTICES AND TESTING ,Pass,51,18,69,BUSINESS INTELLIGENCE ,Pass,56,19,75,J2EE ,Fail,16,17,33,J2EE AND SOFTWARE TESTING LABORATORY,Pass,42,17,59,PROJECT AND VIVA VOCE ,Pass,180,51,231
M1611057, College : 4241  -  JAIN COLLEGE OF BBA  BCA AND COMMERCE  BELAGAVI,FAIL,63.29,SOFTWARE PRACTICES AND TESTING ,Pass,54,14,68,BUSINESS INTELLIGENCE ,Pass,49,15,64,J2EE ,Fail,18,15,33,J2EE AND SOFTWARE TESTING LABORATORY,Pass,46,15,61,PROJECT AND VIVA VOCE ,Pass,170,47,217
M1611058, College : 4241  -  JAIN COLLEGE OF BBA  BCA AND COMMERCE  BELAGAVI,FAIL,59,SOFTWARE PRACTICES AND TESTING ,Pass,53,14,67,BUSINESS INTELLIGENCE ,Pass,51,13,64,J2EE ,Fail,22,14,36,J2EE AND SOFTWARE TESTING LABORATORY,Pass,32,17,49,PROJECT AND VIVA VOCE ,Pass,150,47,197
M1611059, College : 4241  -  JAIN COLLEGE OF BBA  BCA AND COMMERCE  BELAGAVI,DISTI,77.92,SOFTWARE PRACTICES AND TESTING ,Pass,61,17,78,BUSINESS INTELLIGENCE ,Pass,62,19,81,J2EE ,Pass,32,18,50,J2EE AND SOFTWARE TESTING LABORATORY,Pass,66,18,84,PROJECT AND VIVA VOCE ,Pass,200,56,256
M1611060, College : 4241  -  JAIN COLLEGE OF BBA  BCA AND COMMERCE  BELAGAVI,FAIL,53.43,SOFTWARE PRACTICES AND TESTING ,Pass,41,12,53,BUSINESS INTELLIGENCE ,Pass,38,11,49,J2EE ,Fail,16,11,27,J2EE AND SOFTWARE TESTING LABORATORY,Pass,32,13,45,PROJECT AND VIVA VOCE ,Pass,160,40,200
M1611061, College : 4241  -  JAIN COLLEGE OF BBA  BCA AND COMMERCE  BELAGAVI,N.C.L,--   ,SOFTWARE PRACTICES AND TESTING ,Pass,48,15,63,BUSINESS INTELLIGENCE ,Pass,41,16,57,J2EE ,Pass,32,16,48,J2EE AND SOFTWARE TESTING LABORATORY,Pass,38,16,54,PROJECT AND VIVA VOCE ,Pass,200,49,249
M1611063, College : 4241  -  JAIN COLLEGE OF BBA  BCA AND COMMERCE  BELAGAVI,DISTI,81.19,SOFTWARE PRACTICES AND TESTING ,Pass,70,16,86,BUSINESS INTELLIGENCE ,Pass,55,18,73,J2EE ,Pass,49,16,65,J2EE AND SOFTWARE TESTING LABORATORY,Pass,61,16,77,PROJECT AND VIVA VOCE ,Pass,180,49,229
M1611064, College : 4241  -  JAIN COLLEGE OF BBA  BCA AND COMMERCE  BELAGAVI,FAIL,56,SOFTWARE PRACTICES AND TESTING ,Pass,38,9,47,BUSINESS INTELLIGENCE ,Pass,33,9,42,J2EE ,Fail,20,9,29,J2EE AND SOFTWARE TESTING LABORATORY,Pass,32,15,47,PROJECT AND VIVA VOCE ,Pass,180,47,227
M1611065, College : 4241  -  JAIN COLLEGE OF BBA  BCA AND COMMERCE  BELAGAVI,1ST C,64.35,SOFTWARE PRACTICES AND TESTING ,Pass,52,9,61,BUSINESS INTELLIGENCE ,Pass,36,9,45,J2EE ,Pass,37,9,46,J2EE AND SOFTWARE TESTING LABORATORY,Pass,57,15,72,PROJECT AND VIVA VOCE ,Pass,170,45,215
M1611201, College : 4251  -  B K COLLEGE OF ARTS  SCIENCE & COMMERCE  CHIKKODI,DISTI,74.14,SOFTWARE PRACTICES AND TESTING ,Pass,61,16,77,BUSINESS INTELLIGENCE ,Pass,36,16,52,J2EE ,Pass,50,16,66,J2EE AND SOFTWARE TESTING LABORATORY,Pass,60,8,68,PROJECT AND VIVA VOCE ,Pass,230,44,274
M1611202, College : 4251  -  B K COLLEGE OF ARTS  SCIENCE & COMMERCE  CHIKKODI,FAIL,54.43,SOFTWARE PRACTICES AND TESTING ,Pass,40,8,48,BUSINESS INTELLIGENCE ,Fail,16,8,24,J2EE ,Pass,32,8,40,J2EE AND SOFTWARE TESTING LABORATORY,Pass,35,10,45,PROJECT AND VIVA VOCE ,Pass,180,44,224
M1611203, College : 4251  -  B K COLLEGE OF ARTS  SCIENCE & COMMERCE  CHIKKODI,DISTI,78.59,SOFTWARE PRACTICES AND TESTING ,Pass,66,18,84,BUSINESS INTELLIGENCE ,Pass,45,19,64,J2EE ,Pass,53,18,71,J2EE AND SOFTWARE TESTING LABORATORY,Pass,67,20,87,PROJECT AND VIVA VOCE ,Pass,233,59,292
M1611204, College : 4251  -  B K COLLEGE OF ARTS  SCIENCE & COMMERCE  CHIKKODI,DISTI,77.62,SOFTWARE PRACTICES AND TESTING ,Pass,72,19,91,BUSINESS INTELLIGENCE ,Pass,41,18,59,J2EE ,Pass,56,18,74,J2EE AND SOFTWARE TESTING LABORATORY,Pass,74,20,94,PROJECT AND VIVA VOCE ,Pass,235,59,294
M1611206, College : 4251  -  B K COLLEGE OF ARTS  SCIENCE & COMMERCE  CHIKKODI,DISTI,71.7,SOFTWARE PRACTICES AND TESTING ,Pass,57,18,75,BUSINESS INTELLIGENCE ,Pass,39,18,57,J2EE ,Pass,45,19,64,J2EE AND SOFTWARE TESTING LABORATORY,Pass,66,17,83,PROJECT AND VIVA VOCE ,Pass,220,59,279
M1611207, College : 4251  -  B K COLLEGE OF ARTS  SCIENCE & COMMERCE  CHIKKODI,DISTI,87.86,SOFTWARE PRACTICES AND TESTING ,Pass,73,20,93,BUSINESS INTELLIGENCE ,Pass,61,18,79,J2EE ,Pass,60,19,79,J2EE AND SOFTWARE TESTING LABORATORY,Pass,76,8,84,PROJECT AND VIVA VOCE ,Pass,235,59,294
M1611208, College : 4251  -  B K COLLEGE OF ARTS  SCIENCE & COMMERCE  CHIKKODI,1ST C,65.51,SOFTWARE PRACTICES AND TESTING ,Pass,35,16,51,BUSINESS INTELLIGENCE ,Pass,44,17,61,J2EE ,Pass,32,17,49,J2EE AND SOFTWARE TESTING LABORATORY,Pass,53,18,71,PROJECT AND VIVA VOCE ,Pass,209,55,264
M1611209, College : 4251  -  B K COLLEGE OF ARTS  SCIENCE & COMMERCE  CHIKKODI,N.C.L,--   ,SOFTWARE PRACTICES AND TESTING ,Pass,70,15,85,BUSINESS INTELLIGENCE ,Pass,32,15,47,J2EE ,Pass,50,15,65,J2EE AND SOFTWARE TESTING LABORATORY,Pass,57,13,70,PROJECT AND VIVA VOCE ,Pass,210,54,264
M1611210, College : 4251  -  B K COLLEGE OF ARTS  SCIENCE & COMMERCE  CHIKKODI,FAIL,51,SOFTWARE PRACTICES AND TESTING ,Fail,18,8,26,BUSINESS INTELLIGENCE ,Fail,17,8,25,J2EE ,Pass,44,8,52,J2EE AND SOFTWARE TESTING LABORATORY,Pass,32,8,40,PROJECT AND VIVA VOCE ,Pass,180,34,214
M1611212, College : 4251  -  B K COLLEGE OF ARTS  SCIENCE & COMMERCE  CHIKKODI,DISTI,72.3,SOFTWARE PRACTICES AND TESTING ,Pass,56,15,71,BUSINESS INTELLIGENCE ,Pass,39,15,54,J2EE ,Pass,41,15,56,J2EE AND SOFTWARE TESTING LABORATORY,Pass,60,16,76,PROJECT AND VIVA VOCE ,Pass,232,50,282
M1611214, College : 4251  -  B K COLLEGE OF ARTS  SCIENCE & COMMERCE  CHIKKODI,DISTI,74.95,SOFTWARE PRACTICES AND TESTING ,Pass,60,15,75,BUSINESS INTELLIGENCE ,Pass,61,16,77,J2EE ,Pass,53,14,67,J2EE AND SOFTWARE TESTING LABORATORY,Pass,72,15,87,PROJECT AND VIVA VOCE ,Pass,190,36,226
M1611215, College : 4251  -  B K COLLEGE OF ARTS  SCIENCE & COMMERCE  CHIKKODI,N.C.L,--   ,SOFTWARE PRACTICES AND TESTING ,Pass,44,8,52,BUSINESS INTELLIGENCE ,Pass,33,8,41,J2EE ,Pass,39,8,47,J2EE AND SOFTWARE TESTING LABORATORY,Pass,45,8,53,PROJECT AND VIVA VOCE ,Pass,230,50,280
M1611216, College : 4251  -  B K COLLEGE OF ARTS  SCIENCE & COMMERCE  CHIKKODI,DISTI,80.35,SOFTWARE PRACTICES AND TESTING ,Pass,70,8,78,BUSINESS INTELLIGENCE ,Pass,49,8,57,J2EE ,Pass,42,8,50,J2EE AND SOFTWARE TESTING LABORATORY,Pass,74,17,91,PROJECT AND VIVA VOCE ,Pass,238,48,286
M1611217, College : 4251  -  B K COLLEGE OF ARTS  SCIENCE & COMMERCE  CHIKKODI,DISTI,72.43,SOFTWARE PRACTICES AND TESTING ,Pass,68,13,81,BUSINESS INTELLIGENCE ,Pass,47,14,61,J2EE ,Pass,47,10,57,J2EE AND SOFTWARE TESTING LABORATORY,Pass,45,8,53,PROJECT AND VIVA VOCE ,Pass,180,46,226
M1611218, College : 4251  -  B K COLLEGE OF ARTS  SCIENCE & COMMERCE  CHIKKODI,1ST C,66.27,SOFTWARE PRACTICES AND TESTING ,Pass,65,8,73,BUSINESS INTELLIGENCE ,Pass,60,8,68,J2EE ,Pass,52,8,60,J2EE AND SOFTWARE TESTING LABORATORY,Pass,55,15,70,PROJECT AND VIVA VOCE ,Pass,190,36,226
M1611219, College : 4251  -  B K COLLEGE OF ARTS  SCIENCE & COMMERCE  CHIKKODI,N.C.L,--   ,SOFTWARE PRACTICES AND TESTING ,Pass,56,15,71,BUSINESS INTELLIGENCE ,Pass,60,15,75,J2EE ,Pass,53,15,68,J2EE AND SOFTWARE TESTING LABORATORY,Pass,50,14,64,PROJECT AND VIVA VOCE ,Pass,225,39,264
M1611220, College : 4251  -  B K COLLEGE OF ARTS  SCIENCE & COMMERCE  CHIKKODI,DISTI,71.62,SOFTWARE PRACTICES AND TESTING ,Pass,61,17,78,BUSINESS INTELLIGENCE ,Pass,64,15,79,J2EE ,Pass,42,16,58,J2EE AND SOFTWARE TESTING LABORATORY,Pass,70,14,84,PROJECT AND VIVA VOCE ,Pass,230,50,280
M1611221, College : 4251  -  B K COLLEGE OF ARTS  SCIENCE & COMMERCE  CHIKKODI,1ST C,67.76,SOFTWARE PRACTICES AND TESTING ,Pass,40,14,54,BUSINESS INTELLIGENCE ,Pass,56,15,71,J2EE ,Pass,43,12,55,J2EE AND SOFTWARE TESTING LABORATORY,Pass,66,14,80,PROJECT AND VIVA VOCE ,Pass,190,39,229
M1611222, College : 4251  -  B K COLLEGE OF ARTS  SCIENCE & COMMERCE  CHIKKODI,DISTI,71.41,SOFTWARE PRACTICES AND TESTING ,Pass,70,8,78,BUSINESS INTELLIGENCE ,Pass,62,13,75,J2EE ,Pass,55,8,63,J2EE AND SOFTWARE TESTING LABORATORY,Pass,45,8,53,PROJECT AND VIVA VOCE ,Pass,180,50,230
M1611223, College : 4251  -  B K COLLEGE OF ARTS  SCIENCE & COMMERCE  CHIKKODI,1ST C,68.97,SOFTWARE PRACTICES AND TESTING ,Pass,37,9,46,BUSINESS INTELLIGENCE ,Pass,40,10,50,J2EE ,Pass,40,10,50,J2EE AND SOFTWARE TESTING LABORATORY,Pass,76,17,93,PROJECT AND VIVA VOCE ,Pass,180,39,219
M1611224, College : 4251  -  B K COLLEGE OF ARTS  SCIENCE & COMMERCE  CHIKKODI,N.C.L,--   ,SOFTWARE PRACTICES AND TESTING ,Pass,40,8,48,BUSINESS INTELLIGENCE ,Pass,32,8,40,J2EE ,Pass,43,8,51,J2EE AND SOFTWARE TESTING LABORATORY,Pass,62,8,70,PROJECT AND VIVA VOCE ,Pass,190,32,222
M1611225, College : 4251  -  B K COLLEGE OF ARTS  SCIENCE & COMMERCE  CHIKKODI,FAIL,72.86,SOFTWARE PRACTICES AND TESTING ,Pass,37,10,47,BUSINESS INTELLIGENCE ,Pass,50,10,60,J2EE ,Fail,21,10,31,J2EE AND SOFTWARE TESTING LABORATORY,Pass,61,15,76,PROJECT AND VIVA VOCE ,Pass,237,59,296
M1611226, College : 4251  -  B K COLLEGE OF ARTS  SCIENCE & COMMERCE  CHIKKODI,DISTI,78.51,SOFTWARE PRACTICES AND TESTING ,Pass,36,16,52,BUSINESS INTELLIGENCE ,Pass,62,16,78,J2EE ,Pass,50,16,66,J2EE AND SOFTWARE TESTING LABORATORY,Pass,72,20,92,PROJECT AND VIVA VOCE ,Pass,200,44,244
M1611227, College : 4251  -  B K COLLEGE OF ARTS  SCIENCE & COMMERCE  CHIKKODI,1ST C,69.03,SOFTWARE PRACTICES AND TESTING ,Pass,55,16,71,BUSINESS INTELLIGENCE ,Pass,48,15,63,J2EE ,Pass,44,15,59,J2EE AND SOFTWARE TESTING LABORATORY,Pass,78,15,93,PROJECT AND VIVA VOCE ,Pass,230,54,284
M1611228, College : 4251  -  B K COLLEGE OF ARTS  SCIENCE & COMMERCE  CHIKKODI,DISTI,72.78,SOFTWARE PRACTICES AND TESTING ,Pass,61,16,77,BUSINESS INTELLIGENCE ,Pass,66,15,81,J2EE ,Pass,32,15,47,J2EE AND SOFTWARE TESTING LABORATORY,Pass,73,15,88,PROJECT AND VIVA VOCE ,Pass,230,54,284
M1611229, College : 4251  -  B K COLLEGE OF ARTS  SCIENCE & COMMERCE  CHIKKODI,FAIL,51.14,SOFTWARE PRACTICES AND TESTING ,Pass,36,8,44,BUSINESS INTELLIGENCE ,Pass,38,8,46,J2EE ,Fail,13,8,21,J2EE AND SOFTWARE TESTING LABORATORY,Pass,50,13,63,PROJECT AND VIVA VOCE ,Pass,150,34,184
M1611230, College : 4251  -  B K COLLEGE OF ARTS  SCIENCE & COMMERCE  CHIKKODI,FAIL,50.86,SOFTWARE PRACTICES AND TESTING ,Pass,32,8,40,BUSINESS INTELLIGENCE ,Pass,39,8,47,J2EE ,Fail,17,8,25,J2EE AND SOFTWARE TESTING LABORATORY,Pass,60,10,70,PROJECT AND VIVA VOCE ,Pass,140,34,174
M1611231, College : 4251  -  B K COLLEGE OF ARTS  SCIENCE & COMMERCE  CHIKKODI,FAIL,53.43,SOFTWARE PRACTICES AND TESTING ,Pass,41,8,49,BUSINESS INTELLIGENCE ,Pass,36,8,44,J2EE ,Fail,11,8,19,J2EE AND SOFTWARE TESTING LABORATORY,Pass,40,8,48,PROJECT AND VIVA VOCE ,Pass,180,34,214
M1611232, College : 4251  -  B K COLLEGE OF ARTS  SCIENCE & COMMERCE  CHIKKODI,FAIL,49,SOFTWARE PRACTICES AND TESTING ,Pass,38,8,46,BUSINESS INTELLIGENCE ,Fail,14,8,22,J2EE ,Fail,5,8,13,J2EE AND SOFTWARE TESTING LABORATORY,Pass,40,8,48,PROJECT AND VIVA VOCE ,Pass,180,34,214
M1611233, College : 4251  -  B K COLLEGE OF ARTS  SCIENCE & COMMERCE  CHIKKODI,DISTI,76.46,SOFTWARE PRACTICES AND TESTING ,Pass,65,10,75,BUSINESS INTELLIGENCE ,Pass,57,12,69,J2EE ,Pass,34,8,42,J2EE AND SOFTWARE TESTING LABORATORY,Pass,60,18,78,PROJECT AND VIVA VOCE ,Pass,200,44,244
M1611234, College : 4251  -  B K COLLEGE OF ARTS  SCIENCE & COMMERCE  CHIKKODI,DISTI,74.19,SOFTWARE PRACTICES AND TESTING ,Pass,54,16,70,BUSINESS INTELLIGENCE ,Pass,47,16,63,J2EE ,Pass,32,16,48,J2EE AND SOFTWARE TESTING LABORATORY,Pass,78,15,93,PROJECT AND VIVA VOCE ,Pass,235,58,293
M1611235, College : 4251  -  B K COLLEGE OF ARTS  SCIENCE & COMMERCE  CHIKKODI,DISTI,83.89,SOFTWARE PRACTICES AND TESTING ,Pass,61,20,81,BUSINESS INTELLIGENCE ,Pass,68,20,88,J2EE ,Pass,46,20,66,J2EE AND SOFTWARE TESTING LABORATORY,Pass,79,20,99,PROJECT AND VIVA VOCE ,Pass,230,58,288
M1611236, College : 4251  -  B K COLLEGE OF ARTS  SCIENCE & COMMERCE  CHIKKODI,N.C.L,--   ,SOFTWARE PRACTICES AND TESTING ,Pass,54,11,65,BUSINESS INTELLIGENCE ,Pass,68,10,78,J2EE ,Pass,32,10,42,J2EE AND SOFTWARE TESTING LABORATORY,Pass,55,8,63,PROJECT AND VIVA VOCE ,Pass,210,35,245
M1611237, College : 4251  -  B K COLLEGE OF ARTS  SCIENCE & COMMERCE  CHIKKODI,DISTI,73.49,SOFTWARE PRACTICES AND TESTING ,Pass,68,15,83,BUSINESS INTELLIGENCE ,Pass,58,16,74,J2EE ,Pass,32,10,42,J2EE AND SOFTWARE TESTING LABORATORY,Pass,69,15,84,PROJECT AND VIVA VOCE ,Pass,200,50,250
M1611238, College : 4251  -  B K COLLEGE OF ARTS  SCIENCE & COMMERCE  CHIKKODI,FAIL,70,SOFTWARE PRACTICES AND TESTING ,Pass,50,14,64,BUSINESS INTELLIGENCE ,Pass,52,12,64,J2EE ,Fail,20,12,32,J2EE AND SOFTWARE TESTING LABORATORY,Pass,61,15,76,PROJECT AND VIVA VOCE ,Pass,200,54,254
M1611239, College : 4251  -  B K COLLEGE OF ARTS  SCIENCE & COMMERCE  CHIKKODI,FAIL,68.86,SOFTWARE PRACTICES AND TESTING ,Pass,46,14,60,BUSINESS INTELLIGENCE ,Pass,50,14,64,J2EE ,Fail,17,14,31,J2EE AND SOFTWARE TESTING LABORATORY,Pass,43,8,51,PROJECT AND VIVA VOCE ,Pass,220,56,276
M1611240, College : 4251  -  B K COLLEGE OF ARTS  SCIENCE & COMMERCE  CHIKKODI,FAIL,69.43,SOFTWARE PRACTICES AND TESTING ,Pass,51,16,67,BUSINESS INTELLIGENCE ,Pass,32,15,47,J2EE ,Fail,13,15,28,J2EE AND SOFTWARE TESTING LABORATORY,Pass,45,8,53,PROJECT AND VIVA VOCE ,Pass,235,56,291
M1611241, College : 4251  -  B K COLLEGE OF ARTS  SCIENCE & COMMERCE  CHIKKODI,1ST C,68.16,SOFTWARE PRACTICES AND TESTING ,Pass,47,14,61,BUSINESS INTELLIGENCE ,Pass,52,15,67,J2EE ,Pass,47,10,57,J2EE AND SOFTWARE TESTING LABORATORY,Pass,65,8,73,PROJECT AND VIVA VOCE ,Pass,170,46,216
M1611242, College : 4251  -  B K COLLEGE OF ARTS  SCIENCE & COMMERCE  CHIKKODI,DISTI,76.92,SOFTWARE PRACTICES AND TESTING ,Pass,37,18,55,BUSINESS INTELLIGENCE ,Pass,51,18,69,J2EE ,Pass,62,18,80,J2EE AND SOFTWARE TESTING LABORATORY,Pass,56,15,71,PROJECT AND VIVA VOCE ,Pass,210,58,268
M1611244, College : 4251  -  B K COLLEGE OF ARTS  SCIENCE & COMMERCE  CHIKKODI,1ST C,64.68,SOFTWARE PRACTICES AND TESTING ,Pass,48,11,59,BUSINESS INTELLIGENCE ,Pass,54,10,64,J2EE ,Pass,52,10,62,J2EE AND SOFTWARE TESTING LABORATORY,Pass,45,15,60,PROJECT AND VIVA VOCE ,Pass,160,46,206
M1611245, College : 4251  -  B K COLLEGE OF ARTS  SCIENCE & COMMERCE  CHIKKODI,FAIL,51.14,SOFTWARE PRACTICES AND TESTING ,Pass,32,8,40,BUSINESS INTELLIGENCE ,Pass,32,8,40,J2EE ,Fail,15,8,23,J2EE AND SOFTWARE TESTING LABORATORY,Pass,35,10,45,PROJECT AND VIVA VOCE ,Pass,180,30,210
M1611246, College : 4251  -  B K COLLEGE OF ARTS  SCIENCE & COMMERCE  CHIKKODI,N.C.L,--   ,SOFTWARE PRACTICES AND TESTING ,Pass,39,15,54,BUSINESS INTELLIGENCE ,Pass,49,16,65,J2EE ,Pass,51,15,66,J2EE AND SOFTWARE TESTING LABORATORY,Pass,45,14,59,PROJECT AND VIVA VOCE ,Pass,230,49,279
M1611247, College : 4251  -  B K COLLEGE OF ARTS  SCIENCE & COMMERCE  CHIKKODI,N.C.L,--   ,SOFTWARE PRACTICES AND TESTING ,Pass,43,15,58,BUSINESS INTELLIGENCE ,Pass,62,15,77,J2EE ,Pass,50,15,65,J2EE AND SOFTWARE TESTING LABORATORY,Pass,70,19,89,PROJECT AND VIVA VOCE ,Pass,200,39,239
M1611248, College : 4251  -  B K COLLEGE OF ARTS  SCIENCE & COMMERCE  CHIKKODI,DISTI,83.73,SOFTWARE PRACTICES AND TESTING ,Pass,55,15,70,BUSINESS INTELLIGENCE ,Pass,54,15,69,J2EE ,Pass,50,15,65,J2EE AND SOFTWARE TESTING LABORATORY,Pass,60,19,79,PROJECT AND VIVA VOCE ,Pass,232,54,286
M1611249, College : 4251  -  B K COLLEGE OF ARTS  SCIENCE & COMMERCE  CHIKKODI,DISTI,76.57,SOFTWARE PRACTICES AND TESTING ,Pass,44,18,62,BUSINESS INTELLIGENCE ,Pass,49,18,67,J2EE ,Pass,51,18,69,J2EE AND SOFTWARE TESTING LABORATORY,Pass,72,20,92,PROJECT AND VIVA VOCE ,Pass,233,54,287
M1611250, College : 4251  -  B K COLLEGE OF ARTS  SCIENCE & COMMERCE  CHIKKODI,DISTI,83.73,SOFTWARE PRACTICES AND TESTING ,Pass,55,19,74,BUSINESS INTELLIGENCE ,Pass,76,19,95,J2EE ,Pass,66,19,85,J2EE AND SOFTWARE TESTING LABORATORY,Pass,67,19,86,PROJECT AND VIVA VOCE ,Pass,225,59,284
M1611251, College : 4251  -  B K COLLEGE OF ARTS  SCIENCE & COMMERCE  CHIKKODI,FAIL,39.86,SOFTWARE PRACTICES AND TESTING ,Fail,11,8,19,BUSINESS INTELLIGENCE ,Pass,41,8,49,J2EE ,Fail,19,8,27,J2EE AND SOFTWARE TESTING LABORATORY,Pass,32,8,40,PROJECT AND VIVA VOCE ,Pass,120,24,144
M1611254, College : 4251  -  B K COLLEGE OF ARTS  SCIENCE & COMMERCE  CHIKKODI,DISTI,76.22,SOFTWARE PRACTICES AND TESTING ,Pass,47,14,61,BUSINESS INTELLIGENCE ,Pass,63,15,78,J2EE ,Pass,42,15,57,J2EE AND SOFTWARE TESTING LABORATORY,Pass,65,19,84,PROJECT AND VIVA VOCE ,Pass,230,56,286
M1611255, College : 4251  -  B K COLLEGE OF ARTS  SCIENCE & COMMERCE  CHIKKODI,DISTI,77.7,SOFTWARE PRACTICES AND TESTING ,Pass,48,15,63,BUSINESS INTELLIGENCE ,Pass,60,16,76,J2EE ,Pass,58,16,74,J2EE AND SOFTWARE TESTING LABORATORY,Pass,75,19,94,PROJECT AND VIVA VOCE ,Pass,230,54,284
M1611256, College : 4251  -  B K COLLEGE OF ARTS  SCIENCE & COMMERCE  CHIKKODI,FAIL,40.43,SOFTWARE PRACTICES AND TESTING ,Pass,32,8,40,BUSINESS INTELLIGENCE ,Pass,32,8,40,J2EE ,Fail,7,8,15,J2EE AND SOFTWARE TESTING LABORATORY,Pass,35,8,43,PROJECT AND VIVA VOCE ,Pass,110,35,145
M1611257, College : 4251  -  B K COLLEGE OF ARTS  SCIENCE & COMMERCE  CHIKKODI,DISTI,80.08,SOFTWARE PRACTICES AND TESTING ,Pass,65,18,83,BUSINESS INTELLIGENCE ,Pass,55,18,73,J2EE ,Pass,43,18,61,J2EE AND SOFTWARE TESTING LABORATORY,Pass,73,8,81,PROJECT AND VIVA VOCE ,Pass,230,58,288
M1611258, College : 4251  -  B K COLLEGE OF ARTS  SCIENCE & COMMERCE  CHIKKODI,N.C.L,--   ,SOFTWARE PRACTICES AND TESTING ,Pass,35,8,43,BUSINESS INTELLIGENCE ,Pass,46,8,54,J2EE ,Pass,32,8,40,J2EE AND SOFTWARE TESTING LABORATORY,Pass,70,8,78,PROJECT AND VIVA VOCE ,Pass,210,58,268
M1611259, College : 4251  -  B K COLLEGE OF ARTS  SCIENCE & COMMERCE  CHIKKODI,N.C.L,--   ,SOFTWARE PRACTICES AND TESTING ,Pass,56,20,76,BUSINESS INTELLIGENCE ,Pass,46,20,66,J2EE ,Pass,43,20,63,J2EE AND SOFTWARE TESTING LABORATORY,Pass,66,20,86,PROJECT AND VIVA VOCE ,Pass,220,54,274
M1611260, College : 4251  -  B K COLLEGE OF ARTS  SCIENCE & COMMERCE  CHIKKODI,DISTI,70.89,SOFTWARE PRACTICES AND TESTING ,Pass,54,12,66,BUSINESS INTELLIGENCE ,Pass,61,12,73,J2EE ,Pass,45,12,57,J2EE AND SOFTWARE TESTING LABORATORY,Pass,55,19,74,PROJECT AND VIVA VOCE ,Pass,230,43,273
M1611261, College : 4251  -  B K COLLEGE OF ARTS  SCIENCE & COMMERCE  CHIKKODI,DISTI,73.08,SOFTWARE PRACTICES AND TESTING ,Pass,63,15,78,BUSINESS INTELLIGENCE ,Pass,44,15,59,J2EE ,Pass,44,15,59,J2EE AND SOFTWARE TESTING LABORATORY,Pass,71,15,86,PROJECT AND VIVA VOCE ,Pass,235,44,279
M1611263, College : 4251  -  B K COLLEGE OF ARTS  SCIENCE & COMMERCE  CHIKKODI,DISTI,75.41,SOFTWARE PRACTICES AND TESTING ,Pass,69,20,89,BUSINESS INTELLIGENCE ,Pass,61,20,81,J2EE ,Pass,44,20,64,J2EE AND SOFTWARE TESTING LABORATORY,Pass,72,20,92,PROJECT AND VIVA VOCE ,Pass,235,54,289
M1611265, College : 4251  -  B K COLLEGE OF ARTS  SCIENCE & COMMERCE  CHIKKODI,DISTI,71.11,SOFTWARE PRACTICES AND TESTING ,Pass,61,16,77,BUSINESS INTELLIGENCE ,Pass,33,16,49,J2EE ,Pass,34,16,50,J2EE AND SOFTWARE TESTING LABORATORY,Pass,72,8,80,PROJECT AND VIVA VOCE ,Pass,230,40,270
M1611266, College : 4251  -  B K COLLEGE OF ARTS  SCIENCE & COMMERCE  CHIKKODI,N.C.L,--   ,SOFTWARE PRACTICES AND TESTING ,Pass,48,8,56,BUSINESS INTELLIGENCE ,Pass,40,8,48,J2EE ,Pass,35,8,43,J2EE AND SOFTWARE TESTING LABORATORY,Pass,45,8,53,PROJECT AND VIVA VOCE ,Pass,200,30,230
M1611267, College : 4251  -  B K COLLEGE OF ARTS  SCIENCE & COMMERCE  CHIKKODI,N.C.L,--   ,SOFTWARE PRACTICES AND TESTING ,Pass,44,14,58,BUSINESS INTELLIGENCE ,Pass,32,14,46,J2EE ,Pass,32,14,46,J2EE AND SOFTWARE TESTING LABORATORY,Pass,32,8,40,PROJECT AND VIVA VOCE ,Pass,200,40,240
M1611268, College : 4251  -  B K COLLEGE OF ARTS  SCIENCE & COMMERCE  CHIKKODI,FAIL,70.29,SOFTWARE PRACTICES AND TESTING ,Pass,55,14,69,BUSINESS INTELLIGENCE ,Pass,44,14,58,J2EE ,Fail,18,14,32,J2EE AND SOFTWARE TESTING LABORATORY,Pass,52,8,60,PROJECT AND VIVA VOCE ,Pass,235,38,273
M1611269, College : 4251  -  B K COLLEGE OF ARTS  SCIENCE & COMMERCE  CHIKKODI,DISTI,86.49,SOFTWARE PRACTICES AND TESTING ,Pass,52,20,72,BUSINESS INTELLIGENCE ,Pass,64,20,84,J2EE ,Pass,51,20,71,J2EE AND SOFTWARE TESTING LABORATORY,Pass,78,15,93,PROJECT AND VIVA VOCE ,Pass,235,52,287
M1611271, College : 4251  -  B K COLLEGE OF ARTS  SCIENCE & COMMERCE  CHIKKODI,1ST C,68.19,SOFTWARE PRACTICES AND TESTING ,Pass,37,10,47,BUSINESS INTELLIGENCE ,Pass,35,10,45,J2EE ,Pass,45,10,55,J2EE AND SOFTWARE TESTING LABORATORY,Pass,62,15,77,PROJECT AND VIVA VOCE ,Pass,230,52,282
M1611272, College : 4251  -  B K COLLEGE OF ARTS  SCIENCE & COMMERCE  CHIKKODI,1ST C,68.97,SOFTWARE PRACTICES AND TESTING ,Pass,42,13,55,BUSINESS INTELLIGENCE ,Pass,38,15,53,J2EE ,Pass,38,10,48,J2EE AND SOFTWARE TESTING LABORATORY,Pass,40,19,59,PROJECT AND VIVA VOCE ,Pass,220,48,268
M1611273, College : 4251  -  B K COLLEGE OF ARTS  SCIENCE & COMMERCE  CHIKKODI,DISTI,77.22,SOFTWARE PRACTICES AND TESTING ,Pass,46,10,56,BUSINESS INTELLIGENCE ,Pass,52,16,68,J2EE ,Pass,44,10,54,J2EE AND SOFTWARE TESTING LABORATORY,Pass,70,15,85,PROJECT AND VIVA VOCE ,Pass,200,40,240
M1611274, College : 4251  -  B K COLLEGE OF ARTS  SCIENCE & COMMERCE  CHIKKODI,DISTI,91.19,SOFTWARE PRACTICES AND TESTING ,Pass,60,18,78,BUSINESS INTELLIGENCE ,Pass,62,18,80,J2EE ,Pass,56,18,74,J2EE AND SOFTWARE TESTING LABORATORY,Pass,72,19,91,PROJECT AND VIVA VOCE ,Pass,230,58,288
M1611275, College : 4251  -  B K COLLEGE OF ARTS  SCIENCE & COMMERCE  CHIKKODI,N.C.L,--   ,SOFTWARE PRACTICES AND TESTING ,Pass,52,12,64,BUSINESS INTELLIGENCE ,Pass,43,12,55,J2EE ,Pass,57,12,69,J2EE AND SOFTWARE TESTING LABORATORY,Pass,73,8,81,PROJECT AND VIVA VOCE ,Pass,230,42,272
M1611276, College : 4251  -  B K COLLEGE OF ARTS  SCIENCE & COMMERCE  CHIKKODI,DISTI,82.08,SOFTWARE PRACTICES AND TESTING ,Pass,70,20,90,BUSINESS INTELLIGENCE ,Pass,57,20,77,J2EE ,Pass,66,20,86,J2EE AND SOFTWARE TESTING LABORATORY,Pass,66,19,85,PROJECT AND VIVA VOCE ,Pass,235,54,289
M1611277, College : 4251  -  B K COLLEGE OF ARTS  SCIENCE & COMMERCE  CHIKKODI,1ST C,65.84,SOFTWARE PRACTICES AND TESTING ,Pass,64,10,74,BUSINESS INTELLIGENCE ,Pass,50,10,60,J2EE ,Pass,42,8,50,J2EE AND SOFTWARE TESTING LABORATORY,Pass,60,13,73,PROJECT AND VIVA VOCE ,Pass,230,49,279
M1611278, College : 4251  -  B K COLLEGE OF ARTS  SCIENCE & COMMERCE  CHIKKODI,DISTI,75.95,SOFTWARE PRACTICES AND TESTING ,Pass,60,12,72,BUSINESS INTELLIGENCE ,Pass,42,10,52,J2EE ,Pass,50,10,60,J2EE AND SOFTWARE TESTING LABORATORY,Pass,62,8,70,PROJECT AND VIVA VOCE ,Pass,180,34,214
M1611279, College : 4251  -  B K COLLEGE OF ARTS  SCIENCE & COMMERCE  CHIKKODI,DISTI,76.86,SOFTWARE PRACTICES AND TESTING ,Pass,70,16,86,BUSINESS INTELLIGENCE ,Pass,44,15,59,J2EE ,Pass,70,10,80,J2EE AND SOFTWARE TESTING LABORATORY,Pass,76,17,93,PROJECT AND VIVA VOCE ,Pass,235,37,272
M1611280, College : 4251  -  B K COLLEGE OF ARTS  SCIENCE & COMMERCE  CHIKKODI,FAIL,67.43,SOFTWARE PRACTICES AND TESTING ,Pass,54,12,66,BUSINESS INTELLIGENCE ,Pass,32,10,42,J2EE ,Fail,19,10,29,J2EE AND SOFTWARE TESTING LABORATORY,Pass,57,14,71,PROJECT AND VIVA VOCE ,Pass,220,44,264
M1611601, College : 4287  -  S.J.P.N.TRUST S B.C.A. COLLEGE  NIDASOSHI,FAIL,6.57,SOFTWARE PRACTICES AND TESTING ,Fail,Ab.,4,4,BUSINESS INTELLIGENCE ,Fail,Ab.,4,4,J2EE ,Fail,Ab.,4,4,J2EE AND SOFTWARE TESTING LABORATORY,Fail,Ab.,4,4,PROJECT AND VIVA VOCE ,Fail,Ab.,30,30
M1611602, College : 4287  -  S.J.P.N.TRUST S B.C.A. COLLEGE  NIDASOSHI,DISTI,70,SOFTWARE PRACTICES AND TESTING ,Pass,61,8,69,BUSINESS INTELLIGENCE ,Pass,42,8,50,J2EE ,Pass,42,9,51,J2EE AND SOFTWARE TESTING LABORATORY,Pass,46,12,58,PROJECT AND VIVA VOCE ,Pass,200,54,254
M1611603, College : 4287  -  S.J.P.N.TRUST S B.C.A. COLLEGE  NIDASOSHI,N.C.L,--   ,SOFTWARE PRACTICES AND TESTING ,Pass,32,15,47,BUSINESS INTELLIGENCE ,Pass,32,14,46,J2EE ,Pass,44,9,53,J2EE AND SOFTWARE TESTING LABORATORY,Pass,57,15,72,PROJECT AND VIVA VOCE ,Pass,200,52,252
M1611604, College : 4287  -  S.J.P.N.TRUST S B.C.A. COLLEGE  NIDASOSHI,DISTI,88.32,SOFTWARE PRACTICES AND TESTING ,Pass,65,16,81,BUSINESS INTELLIGENCE ,Pass,53,18,71,J2EE ,Pass,65,16,81,J2EE AND SOFTWARE TESTING LABORATORY,Pass,75,19,94,PROJECT AND VIVA VOCE ,Pass,235,58,293
M1611605, College : 4287  -  S.J.P.N.TRUST S B.C.A. COLLEGE  NIDASOSHI,DISTI,82.73,SOFTWARE PRACTICES AND TESTING ,Pass,60,16,76,BUSINESS INTELLIGENCE ,Pass,56,18,74,J2EE ,Pass,58,17,75,J2EE AND SOFTWARE TESTING LABORATORY,Pass,75,18,93,PROJECT AND VIVA VOCE ,Pass,233,56,289
M1611606, College : 4287  -  S.J.P.N.TRUST S B.C.A. COLLEGE  NIDASOSHI,N.C.L,--   ,SOFTWARE PRACTICES AND TESTING ,Pass,43,14,57,BUSINESS INTELLIGENCE ,Pass,32,15,47,J2EE ,Pass,53,13,66,J2EE AND SOFTWARE TESTING LABORATORY,Pass,70,16,86,PROJECT AND VIVA VOCE ,Pass,200,50,250
M1611607, College : 4287  -  S.J.P.N.TRUST S B.C.A. COLLEGE  NIDASOSHI,DISTI,79.81,SOFTWARE PRACTICES AND TESTING ,Pass,54,12,66,BUSINESS INTELLIGENCE ,Pass,40,13,53,J2EE ,Pass,60,12,72,J2EE AND SOFTWARE TESTING LABORATORY,Pass,79,19,98,PROJECT AND VIVA VOCE ,Pass,239,60,299
M1611608, College : 4287  -  S.J.P.N.TRUST S B.C.A. COLLEGE  NIDASOSHI,DISTI,80.19,SOFTWARE PRACTICES AND TESTING ,Pass,55,14,69,BUSINESS INTELLIGENCE ,Pass,53,16,69,J2EE ,Pass,64,16,80,J2EE AND SOFTWARE TESTING LABORATORY,Pass,76,16,92,PROJECT AND VIVA VOCE ,Pass,225,54,279
M1611609, College : 4287  -  S.J.P.N.TRUST S B.C.A. COLLEGE  NIDASOSHI,DISTI,76.14,SOFTWARE PRACTICES AND TESTING ,Pass,57,12,69,BUSINESS INTELLIGENCE ,Pass,51,15,66,J2EE ,Pass,64,13,77,J2EE AND SOFTWARE TESTING LABORATORY,Pass,78,14,92,PROJECT AND VIVA VOCE ,Pass,235,57,292
M1611610, College : 4287  -  S.J.P.N.TRUST S B.C.A. COLLEGE  NIDASOSHI,1ST C,69.51,SOFTWARE PRACTICES AND TESTING ,Pass,52,11,63,BUSINESS INTELLIGENCE ,Pass,48,13,61,J2EE ,Pass,58,12,70,J2EE AND SOFTWARE TESTING LABORATORY,Pass,70,13,83,PROJECT AND VIVA VOCE ,Pass,220,57,277
M1611611, College : 4287  -  S.J.P.N.TRUST S B.C.A. COLLEGE  NIDASOSHI,1ST C,68.86,SOFTWARE PRACTICES AND TESTING ,Pass,37,14,51,BUSINESS INTELLIGENCE ,Pass,47,11,58,J2EE ,Pass,49,11,60,J2EE AND SOFTWARE TESTING LABORATORY,Pass,70,18,88,PROJECT AND VIVA VOCE ,Pass,225,57,282
M1611612, College : 4287  -  S.J.P.N.TRUST S B.C.A. COLLEGE  NIDASOSHI,DISTI,72.03,SOFTWARE PRACTICES AND TESTING ,Pass,39,10,49,BUSINESS INTELLIGENCE ,Pass,46,13,59,J2EE ,Pass,56,12,68,J2EE AND SOFTWARE TESTING LABORATORY,Pass,61,12,73,PROJECT AND VIVA VOCE ,Pass,205,52,257
M1611613, College : 4287  -  S.J.P.N.TRUST S B.C.A. COLLEGE  NIDASOSHI,N.C.L,--   ,SOFTWARE PRACTICES AND TESTING ,Pass,37,11,48,BUSINESS INTELLIGENCE ,Pass,34,9,43,J2EE ,Pass,48,13,61,J2EE AND SOFTWARE TESTING LABORATORY,Pass,70,14,84,PROJECT AND VIVA VOCE ,Pass,220,51,271
M1611614, College : 4287  -  S.J.P.N.TRUST S B.C.A. COLLEGE  NIDASOSHI,N.C.L,--   ,SOFTWARE PRACTICES AND TESTING ,Pass,38,15,53,BUSINESS INTELLIGENCE ,Pass,39,15,54,J2EE ,Pass,41,15,56,J2EE AND SOFTWARE TESTING LABORATORY,Pass,35,15,50,PROJECT AND VIVA VOCE ,Pass,210,50,260
M1611615, College : 4287  -  S.J.P.N.TRUST S B.C.A. COLLEGE  NIDASOSHI,DISTI,83.3,SOFTWARE PRACTICES AND TESTING ,Pass,53,16,69,BUSINESS INTELLIGENCE ,Pass,50,16,66,J2EE ,Pass,61,17,78,J2EE AND SOFTWARE TESTING LABORATORY,Pass,71,18,89,PROJECT AND VIVA VOCE ,Pass,210,52,262
M1611616, College : 4287  -  S.J.P.N.TRUST S B.C.A. COLLEGE  NIDASOSHI,1ST C,69.43,SOFTWARE PRACTICES AND TESTING ,Pass,53,17,70,BUSINESS INTELLIGENCE ,Pass,45,15,60,J2EE ,Pass,47,12,59,J2EE AND SOFTWARE TESTING LABORATORY,Pass,51,16,67,PROJECT AND VIVA VOCE ,Pass,205,52,257
M1611617, College : 4287  -  S.J.P.N.TRUST S B.C.A. COLLEGE  NIDASOSHI,DISTI,73.08,SOFTWARE PRACTICES AND TESTING ,Pass,46,17,63,BUSINESS INTELLIGENCE ,Pass,51,15,66,J2EE ,Pass,61,15,76,J2EE AND SOFTWARE TESTING LABORATORY,Pass,65,17,82,PROJECT AND VIVA VOCE ,Pass,215,58,273
M1611618, College : 4287  -  S.J.P.N.TRUST S B.C.A. COLLEGE  NIDASOSHI,DISTI,72.14,SOFTWARE PRACTICES AND TESTING ,Pass,68,16,84,BUSINESS INTELLIGENCE ,Pass,50,16,66,J2EE ,Pass,51,15,66,J2EE AND SOFTWARE TESTING LABORATORY,Pass,64,18,82,PROJECT AND VIVA VOCE ,Pass,210,55,265
M1611619, College : 4287  -  S.J.P.N.TRUST S B.C.A. COLLEGE  NIDASOSHI,DISTI,73.38,SOFTWARE PRACTICES AND TESTING ,Pass,60,16,76,BUSINESS INTELLIGENCE ,Pass,52,13,65,J2EE ,Pass,44,16,60,J2EE AND SOFTWARE TESTING LABORATORY,Pass,75,18,93,PROJECT AND VIVA VOCE ,Pass,230,58,288
M1611620, College : 4287  -  S.J.P.N.TRUST S B.C.A. COLLEGE  NIDASOSHI,DISTI,76.65,SOFTWARE PRACTICES AND TESTING ,Pass,60,12,72,BUSINESS INTELLIGENCE ,Pass,44,13,57,J2EE ,Pass,42,13,55,J2EE AND SOFTWARE TESTING LABORATORY,Pass,70,18,88,PROJECT AND VIVA VOCE ,Pass,230,57,287
M1611621, College : 4287  -  S.J.P.N.TRUST S B.C.A. COLLEGE  NIDASOSHI,N.C.L,--   ,SOFTWARE PRACTICES AND TESTING ,Pass,42,17,59,BUSINESS INTELLIGENCE ,Pass,47,17,64,J2EE ,Pass,50,12,62,J2EE AND SOFTWARE TESTING LABORATORY,Pass,70,18,88,PROJECT AND VIVA VOCE ,Pass,225,57,282
M1611622, College : 4287  -  S.J.P.N.TRUST S B.C.A. COLLEGE  NIDASOSHI,1ST C,64.76,SOFTWARE PRACTICES AND TESTING ,Pass,55,14,69,BUSINESS INTELLIGENCE ,Pass,44,12,56,J2EE ,Pass,55,11,66,J2EE AND SOFTWARE TESTING LABORATORY,Pass,62,16,78,PROJECT AND VIVA VOCE ,Pass,210,54,264
M1611623, College : 4287  -  S.J.P.N.TRUST S B.C.A. COLLEGE  NIDASOSHI,N.C.L,--   ,SOFTWARE PRACTICES AND TESTING ,Pass,41,15,56,BUSINESS INTELLIGENCE ,Pass,41,15,56,J2EE ,Pass,36,15,51,J2EE AND SOFTWARE TESTING LABORATORY,Pass,34,15,49,PROJECT AND VIVA VOCE ,Pass,215,49,264
M1611625, College : 4287  -  S.J.P.N.TRUST S B.C.A. COLLEGE  NIDASOSHI,DISTI,81.78,SOFTWARE PRACTICES AND TESTING ,Pass,57,17,74,BUSINESS INTELLIGENCE ,Pass,54,17,71,J2EE ,Pass,53,16,69,J2EE AND SOFTWARE TESTING LABORATORY,Pass,70,19,89,PROJECT AND VIVA VOCE ,Pass,220,58,278
M1611626, College : 4287  -  S.J.P.N.TRUST S B.C.A. COLLEGE  NIDASOSHI,N.C.L,--   ,SOFTWARE PRACTICES AND TESTING ,Pass,40,12,52,BUSINESS INTELLIGENCE ,Pass,50,16,66,J2EE ,Pass,58,14,72,J2EE AND SOFTWARE TESTING LABORATORY,Pass,72,18,90,PROJECT AND VIVA VOCE ,Pass,210,57,267
M1611629, College : 4287  -  S.J.P.N.TRUST S B.C.A. COLLEGE  NIDASOSHI,DISTI,73.05,SOFTWARE PRACTICES AND TESTING ,Pass,47,13,60,BUSINESS INTELLIGENCE ,Pass,50,10,60,J2EE ,Pass,54,9,63,J2EE AND SOFTWARE TESTING LABORATORY,Pass,71,16,87,PROJECT AND VIVA VOCE ,Pass,225,58,283
M1611630, College : 4287  -  S.J.P.N.TRUST S B.C.A. COLLEGE  NIDASOSHI,N.C.L,--   ,SOFTWARE PRACTICES AND TESTING ,Pass,37,15,52,BUSINESS INTELLIGENCE ,Pass,37,15,52,J2EE ,Pass,39,15,54,J2EE AND SOFTWARE TESTING LABORATORY,Pass,32,15,47,PROJECT AND VIVA VOCE ,Pass,210,48,258
M1611631, College : 4287  -  S.J.P.N.TRUST S B.C.A. COLLEGE  NIDASOSHI,N.C.L,--   ,SOFTWARE PRACTICES AND TESTING ,Pass,34,10,44,BUSINESS INTELLIGENCE ,Pass,36,9,45,J2EE ,Pass,32,9,41,J2EE AND SOFTWARE TESTING LABORATORY,Pass,50,11,61,PROJECT AND VIVA VOCE ,Pass,210,58,268
M1611632, College : 4287  -  S.J.P.N.TRUST S B.C.A. COLLEGE  NIDASOSHI,DISTI,72.27,SOFTWARE PRACTICES AND TESTING ,Pass,48,19,67,BUSINESS INTELLIGENCE ,Pass,42,18,60,J2EE ,Pass,59,14,73,J2EE AND SOFTWARE TESTING LABORATORY,Pass,69,20,89,PROJECT AND VIVA VOCE ,Pass,225,58,283
M1611633, College : 4287  -  S.J.P.N.TRUST S B.C.A. COLLEGE  NIDASOSHI,DISTI,90.59,SOFTWARE PRACTICES AND TESTING ,Pass,71,18,89,BUSINESS INTELLIGENCE ,Pass,58,20,78,J2EE ,Pass,59,20,79,J2EE AND SOFTWARE TESTING LABORATORY,Pass,79,19,98,PROJECT AND VIVA VOCE ,Pass,235,59,294
M1611634, College : 4287  -  S.J.P.N.TRUST S B.C.A. COLLEGE  NIDASOSHI,DISTI,81.46,SOFTWARE PRACTICES AND TESTING ,Pass,61,19,80,BUSINESS INTELLIGENCE ,Pass,60,20,80,J2EE ,Pass,64,20,84,J2EE AND SOFTWARE TESTING LABORATORY,Pass,71,20,91,PROJECT AND VIVA VOCE ,Pass,230,57,287
M1611636, College : 4287  -  S.J.P.N.TRUST S B.C.A. COLLEGE  NIDASOSHI,FAIL,53.14,SOFTWARE PRACTICES AND TESTING ,Fail,8,11,19,BUSINESS INTELLIGENCE ,Fail,8,8,16,J2EE ,Fail,11,8,19,J2EE AND SOFTWARE TESTING LABORATORY,Pass,56,17,73,PROJECT AND VIVA VOCE ,Pass,195,50,245
M1611638, College : 4287  -  S.J.P.N.TRUST S B.C.A. COLLEGE  NIDASOSHI,DISTI,76.78,SOFTWARE PRACTICES AND TESTING ,Pass,54,19,73,BUSINESS INTELLIGENCE ,Pass,47,17,64,J2EE ,Pass,52,14,66,J2EE AND SOFTWARE TESTING LABORATORY,Pass,65,19,84,PROJECT AND VIVA VOCE ,Pass,224,56,280
M1611639, College : 4287  -  S.J.P.N.TRUST S B.C.A. COLLEGE  NIDASOSHI,DISTI,74.49,SOFTWARE PRACTICES AND TESTING ,Pass,61,16,77,BUSINESS INTELLIGENCE ,Pass,53,18,71,J2EE ,Pass,45,16,61,J2EE AND SOFTWARE TESTING LABORATORY,Pass,74,18,92,PROJECT AND VIVA VOCE ,Pass,220,55,275
M1611640, College : 4287  -  S.J.P.N.TRUST S B.C.A. COLLEGE  NIDASOSHI,DISTI,85.24,SOFTWARE PRACTICES AND TESTING ,Pass,54,19,73,BUSINESS INTELLIGENCE ,Pass,58,19,77,J2EE ,Pass,51,19,70,J2EE AND SOFTWARE TESTING LABORATORY,Pass,70,20,90,PROJECT AND VIVA VOCE ,Pass,232,56,288
M1611641, College : 4287  -  S.J.P.N.TRUST S B.C.A. COLLEGE  NIDASOSHI,DISTI,70.22,SOFTWARE PRACTICES AND TESTING ,Pass,58,18,76,BUSINESS INTELLIGENCE ,Pass,48,16,64,J2EE ,Pass,44,15,59,J2EE AND SOFTWARE TESTING LABORATORY,Pass,75,20,95,PROJECT AND VIVA VOCE ,Pass,217,57,274
M1611642, College : 4287  -  S.J.P.N.TRUST S B.C.A. COLLEGE  NIDASOSHI,DISTI,70.49,SOFTWARE PRACTICES AND TESTING ,Pass,51,19,70,BUSINESS INTELLIGENCE ,Pass,56,16,72,J2EE ,Pass,41,15,56,J2EE AND SOFTWARE TESTING LABORATORY,Pass,60,19,79,PROJECT AND VIVA VOCE ,Pass,215,56,271
M1611643, College : 4287  -  S.J.P.N.TRUST S B.C.A. COLLEGE  NIDASOSHI,DISTI,89.11,SOFTWARE PRACTICES AND TESTING ,Pass,66,17,83,BUSINESS INTELLIGENCE ,Pass,72,18,90,J2EE ,Pass,62,16,78,J2EE AND SOFTWARE TESTING LABORATORY,Pass,78,20,98,PROJECT AND VIVA VOCE ,Pass,235,58,293
M1611644, College : 4287  -  S.J.P.N.TRUST S B.C.A. COLLEGE  NIDASOSHI,DISTI,76.76,SOFTWARE PRACTICES AND TESTING ,Pass,48,19,67,BUSINESS INTELLIGENCE ,Pass,62,20,82,J2EE ,Pass,45,14,59,J2EE AND SOFTWARE TESTING LABORATORY,Pass,71,20,91,PROJECT AND VIVA VOCE ,Pass,227,58,285
M1611647, College : 4287  -  S.J.P.N.TRUST S B.C.A. COLLEGE  NIDASOSHI,DISTI,81.41,SOFTWARE PRACTICES AND TESTING ,Pass,62,19,81,BUSINESS INTELLIGENCE ,Pass,71,20,91,J2EE ,Pass,59,19,78,J2EE AND SOFTWARE TESTING LABORATORY,Pass,72,16,88,PROJECT AND VIVA VOCE ,Pass,226,58,284
M1611648, College : 4287  -  S.J.P.N.TRUST S B.C.A. COLLEGE  NIDASOSHI,DISTI,84.68,SOFTWARE PRACTICES AND TESTING ,Pass,70,16,86,BUSINESS INTELLIGENCE ,Pass,74,15,89,J2EE ,Pass,58,19,77,J2EE AND SOFTWARE TESTING LABORATORY,Pass,70,20,90,PROJECT AND VIVA VOCE ,Pass,230,56,286
M1611649, College : 4287  -  S.J.P.N.TRUST S B.C.A. COLLEGE  NIDASOSHI,DISTI,71.14,SOFTWARE PRACTICES AND TESTING ,Pass,60,18,78,BUSINESS INTELLIGENCE ,Pass,66,19,85,J2EE ,Pass,48,12,60,J2EE AND SOFTWARE TESTING LABORATORY,Pass,62,18,80,PROJECT AND VIVA VOCE ,Pass,217,55,272
M1611650, College : 4287  -  S.J.P.N.TRUST S B.C.A. COLLEGE  NIDASOSHI,N.C.L,--   ,SOFTWARE PRACTICES AND TESTING ,Pass,36,15,51,BUSINESS INTELLIGENCE ,Pass,44,18,62,J2EE ,Pass,35,10,45,J2EE AND SOFTWARE TESTING LABORATORY,Pass,60,16,76,PROJECT AND VIVA VOCE ,Pass,210,55,265
M1611651, College : 4287  -  S.J.P.N.TRUST S B.C.A. COLLEGE  NIDASOSHI,DISTI,92.84,SOFTWARE PRACTICES AND TESTING ,Pass,76,20,96,BUSINESS INTELLIGENCE ,Pass,78,20,98,J2EE ,Pass,70,20,90,J2EE AND SOFTWARE TESTING LABORATORY,Pass,78,20,98,PROJECT AND VIVA VOCE ,Pass,235,58,293
M1611652, College : 4287  -  S.J.P.N.TRUST S B.C.A. COLLEGE  NIDASOSHI,DISTI,74.24,SOFTWARE PRACTICES AND TESTING ,Pass,60,18,78,BUSINESS INTELLIGENCE ,Pass,59,15,74,J2EE ,Pass,53,16,69,J2EE AND SOFTWARE TESTING LABORATORY,Pass,64,19,83,PROJECT AND VIVA VOCE ,Pass,220,58,278
M1611653, College : 4287  -  S.J.P.N.TRUST S B.C.A. COLLEGE  NIDASOSHI,FAIL,68,SOFTWARE PRACTICES AND TESTING ,Pass,42,16,58,BUSINESS INTELLIGENCE ,Pass,41,12,53,J2EE ,Fail,19,13,32,J2EE AND SOFTWARE TESTING LABORATORY,Pass,57,17,74,PROJECT AND VIVA VOCE ,Pass,205,54,259
M1611654, College : 4287  -  S.J.P.N.TRUST S B.C.A. COLLEGE  NIDASOSHI,N.C.L,--   ,SOFTWARE PRACTICES AND TESTING ,Pass,44,15,59,BUSINESS INTELLIGENCE ,Pass,44,15,59,J2EE ,Pass,42,15,57,J2EE AND SOFTWARE TESTING LABORATORY,Pass,40,15,55,PROJECT AND VIVA VOCE ,Pass,212,49,261
M1611656, College : 4287  -  S.J.P.N.TRUST S B.C.A. COLLEGE  NIDASOSHI,N.C.L,--   ,SOFTWARE PRACTICES AND TESTING ,Pass,35,14,49,BUSINESS INTELLIGENCE ,Pass,46,16,62,J2EE ,Pass,33,9,42,J2EE AND SOFTWARE TESTING LABORATORY,Pass,57,15,72,PROJECT AND VIVA VOCE ,Pass,175,50,225
M1611657, College : 4287  -  S.J.P.N.TRUST S B.C.A. COLLEGE  NIDASOSHI,DISTI,71.76,SOFTWARE PRACTICES AND TESTING ,Pass,56,18,74,BUSINESS INTELLIGENCE ,Pass,61,15,76,J2EE ,Pass,34,14,48,J2EE AND SOFTWARE TESTING LABORATORY,Pass,65,18,83,PROJECT AND VIVA VOCE ,Pass,200,54,254
M1611658, College : 4287  -  S.J.P.N.TRUST S B.C.A. COLLEGE  NIDASOSHI,DISTI,82.84,SOFTWARE PRACTICES AND TESTING ,Pass,48,20,68,BUSINESS INTELLIGENCE ,Pass,65,19,84,J2EE ,Pass,48,15,63,J2EE AND SOFTWARE TESTING LABORATORY,Pass,76,19,95,PROJECT AND VIVA VOCE ,Pass,229,58,287
M1611659, College : 4287  -  S.J.P.N.TRUST S B.C.A. COLLEGE  NIDASOSHI,FAIL,47.86,SOFTWARE PRACTICES AND TESTING ,Fail,16,12,28,BUSINESS INTELLIGENCE ,Fail,14,9,23,J2EE ,Fail,12,9,21,J2EE AND SOFTWARE TESTING LABORATORY,Pass,40,13,53,PROJECT AND VIVA VOCE ,Pass,160,50,210
M1611660, College : 4287  -  S.J.P.N.TRUST S B.C.A. COLLEGE  NIDASOSHI,DISTI,73.16,SOFTWARE PRACTICES AND TESTING ,Pass,56,16,72,BUSINESS INTELLIGENCE ,Pass,56,16,72,J2EE ,Pass,53,12,65,J2EE AND SOFTWARE TESTING LABORATORY,Pass,62,18,80,PROJECT AND VIVA VOCE ,Pass,205,55,260
M1611661, College : 4287  -  S.J.P.N.TRUST S B.C.A. COLLEGE  NIDASOSHI,FAIL,6.57,SOFTWARE PRACTICES AND TESTING ,Fail,Ab.,4,4,BUSINESS INTELLIGENCE ,Fail,Ab.,4,4,J2EE ,Fail,Ab.,4,4,J2EE AND SOFTWARE TESTING LABORATORY,Fail,Ab.,4,4,PROJECT AND VIVA VOCE ,Fail,Ab.,30,30
M1611662, College : 4287  -  S.J.P.N.TRUST S B.C.A. COLLEGE  NIDASOSHI,DISTI,70.43,SOFTWARE PRACTICES AND TESTING ,Pass,59,10,69,BUSINESS INTELLIGENCE ,Pass,59,13,72,J2EE ,Pass,44,14,58,J2EE AND SOFTWARE TESTING LABORATORY,Pass,53,18,71,PROJECT AND VIVA VOCE ,Pass,200,51,251
M1611663, College : 4287  -  S.J.P.N.TRUST S B.C.A. COLLEGE  NIDASOSHI,FAIL,61.43,SOFTWARE PRACTICES AND TESTING ,Pass,40,9,49,BUSINESS INTELLIGENCE ,Fail,14,11,25,J2EE ,Pass,34,9,43,J2EE AND SOFTWARE TESTING LABORATORY,Pass,45,15,60,PROJECT AND VIVA VOCE ,Pass,195,58,253
M1611664, College : 4287  -  S.J.P.N.TRUST S B.C.A. COLLEGE  NIDASOSHI,DISTI,89.84,SOFTWARE PRACTICES AND TESTING ,Pass,73,18,91,BUSINESS INTELLIGENCE ,Pass,68,20,88,J2EE ,Pass,70,20,90,J2EE AND SOFTWARE TESTING LABORATORY,Pass,70,20,90,PROJECT AND VIVA VOCE ,Pass,230,57,287
M1611665, College : 4287  -  S.J.P.N.TRUST S B.C.A. COLLEGE  NIDASOSHI,DISTI,81.32,SOFTWARE PRACTICES AND TESTING ,Pass,52,9,61,BUSINESS INTELLIGENCE ,Pass,40,14,54,J2EE ,Pass,60,14,74,J2EE AND SOFTWARE TESTING LABORATORY,Pass,76,19,95,PROJECT AND VIVA VOCE ,Pass,230,56,286
M1611666, College : 4287  -  S.J.P.N.TRUST S B.C.A. COLLEGE  NIDASOSHI,DISTI,84.86,SOFTWARE PRACTICES AND TESTING ,Pass,62,16,78,BUSINESS INTELLIGENCE ,Pass,55,19,74,J2EE ,Pass,66,20,86,J2EE AND SOFTWARE TESTING LABORATORY,Pass,77,20,97,PROJECT AND VIVA VOCE ,Pass,230,58,288
M1611667, College : 4287  -  S.J.P.N.TRUST S B.C.A. COLLEGE  NIDASOSHI,DISTI,84.05,SOFTWARE PRACTICES AND TESTING ,Pass,68,19,87,BUSINESS INTELLIGENCE ,Pass,57,19,76,J2EE ,Pass,53,20,73,J2EE AND SOFTWARE TESTING LABORATORY,Pass,76,20,96,PROJECT AND VIVA VOCE ,Pass,228,56,284
M1611668, College : 4287  -  S.J.P.N.TRUST S B.C.A. COLLEGE  NIDASOSHI,DISTI,84.43,SOFTWARE PRACTICES AND TESTING ,Pass,65,18,83,BUSINESS INTELLIGENCE ,Pass,57,20,77,J2EE ,Pass,73,20,93,J2EE AND SOFTWARE TESTING LABORATORY,Pass,76,20,96,PROJECT AND VIVA VOCE ,Pass,230,58,288
M1611669, College : 4287  -  S.J.P.N.TRUST S B.C.A. COLLEGE  NIDASOSHI,DISTI,92.86,SOFTWARE PRACTICES AND TESTING ,Pass,75,18,93,BUSINESS INTELLIGENCE ,Pass,75,20,95,J2EE ,Pass,75,19,94,J2EE AND SOFTWARE TESTING LABORATORY,Pass,79,20,99,PROJECT AND VIVA VOCE ,Pass,235,58,293
M1611670, College : 4287  -  S.J.P.N.TRUST S B.C.A. COLLEGE  NIDASOSHI,DISTI,92.65,SOFTWARE PRACTICES AND TESTING ,Pass,73,18,91,BUSINESS INTELLIGENCE ,Pass,75,20,95,J2EE ,Pass,77,20,97,J2EE AND SOFTWARE TESTING LABORATORY,Pass,76,20,96,PROJECT AND VIVA VOCE ,Pass,230,58,288
M1611671, College : 4287  -  S.J.P.N.TRUST S B.C.A. COLLEGE  NIDASOSHI,N.C.L,--   ,SOFTWARE PRACTICES AND TESTING ,Pass,38,6,44,BUSINESS INTELLIGENCE ,Pass,34,10,44,J2EE ,Pass,36,5,41,J2EE AND SOFTWARE TESTING LABORATORY,Pass,50,12,62,PROJECT AND VIVA VOCE ,Pass,195,52,247
M1611673, College : 4287  -  S.J.P.N.TRUST S B.C.A. COLLEGE  NIDASOSHI,N.C.L,--   ,SOFTWARE PRACTICES AND TESTING ,Pass,60,10,70,BUSINESS INTELLIGENCE ,Pass,39,14,53,J2EE ,Pass,62,10,72,J2EE AND SOFTWARE TESTING LABORATORY,Pass,55,16,71,PROJECT AND VIVA VOCE ,Pass,200,52,252
M1611674, College : 4287  -  S.J.P.N.TRUST S B.C.A. COLLEGE  NIDASOSHI,DISTI,84.51,SOFTWARE PRACTICES AND TESTING ,Pass,56,16,72,BUSINESS INTELLIGENCE ,Pass,58,20,78,J2EE ,Pass,61,20,81,J2EE AND SOFTWARE TESTING LABORATORY,Pass,75,20,95,PROJECT AND VIVA VOCE ,Pass,229,58,287
M1611675, College : 4287  -  S.J.P.N.TRUST S B.C.A. COLLEGE  NIDASOSHI,2ND C,59.54,SOFTWARE PRACTICES AND TESTING ,Pass,53,15,68,BUSINESS INTELLIGENCE ,Pass,49,15,64,J2EE ,Pass,43,15,58,J2EE AND SOFTWARE TESTING LABORATORY,Pass,40,15,55,PROJECT AND VIVA VOCE ,Pass,218,48,266
M1611676, College : 4287  -  S.J.P.N.TRUST S B.C.A. COLLEGE  NIDASOSHI,DISTI,89.46,SOFTWARE PRACTICES AND TESTING ,Pass,60,20,80,BUSINESS INTELLIGENCE ,Pass,48,20,68,J2EE ,Pass,69,20,89,J2EE AND SOFTWARE TESTING LABORATORY,Pass,78,20,98,PROJECT AND VIVA VOCE ,Pass,232,60,292
M1611677, College : 4287  -  S.J.P.N.TRUST S B.C.A. COLLEGE  NIDASOSHI,DISTI,71.49,SOFTWARE PRACTICES AND TESTING ,Pass,52,13,65,BUSINESS INTELLIGENCE ,Pass,34,15,49,J2EE ,Pass,46,15,61,J2EE AND SOFTWARE TESTING LABORATORY,Pass,64,18,82,PROJECT AND VIVA VOCE ,Pass,220,51,271
M1611678, College : 4287  -  S.J.P.N.TRUST S B.C.A. COLLEGE  NIDASOSHI,DISTI,82.7,SOFTWARE PRACTICES AND TESTING ,Pass,61,13,74,BUSINESS INTELLIGENCE ,Pass,63,18,81,J2EE ,Pass,66,19,85,J2EE AND SOFTWARE TESTING LABORATORY,Pass,66,16,82,PROJECT AND VIVA VOCE ,Pass,210,58,268
M1611679, College : 4287  -  S.J.P.N.TRUST S B.C.A. COLLEGE  NIDASOSHI,DISTI,71.16,SOFTWARE PRACTICES AND TESTING ,Pass,50,12,62,BUSINESS INTELLIGENCE ,Pass,55,16,71,J2EE ,Pass,54,18,72,J2EE AND SOFTWARE TESTING LABORATORY,Pass,65,20,85,PROJECT AND VIVA VOCE ,Pass,195,55,250
M1611680, College : 4287  -  S.J.P.N.TRUST S B.C.A. COLLEGE  NIDASOSHI,DISTI,85.05,SOFTWARE PRACTICES AND TESTING ,Pass,62,16,78,BUSINESS INTELLIGENCE ,Pass,62,19,81,J2EE ,Pass,67,20,87,J2EE AND SOFTWARE TESTING LABORATORY,Pass,76,20,96,PROJECT AND VIVA VOCE ,Pass,220,58,278
M1611682, College : 4287  -  S.J.P.N.TRUST S B.C.A. COLLEGE  NIDASOSHI,DISTI,92.78,SOFTWARE PRACTICES AND TESTING ,Pass,68,20,88,BUSINESS INTELLIGENCE ,Pass,68,20,88,J2EE ,Pass,61,20,81,J2EE AND SOFTWARE TESTING LABORATORY,Pass,79,20,99,PROJECT AND VIVA VOCE ,Pass,235,60,295
M1611683, College : 4287  -  S.J.P.N.TRUST S B.C.A. COLLEGE  NIDASOSHI,N.C.L,--   ,SOFTWARE PRACTICES AND TESTING ,Pass,43,10,53,BUSINESS INTELLIGENCE ,Pass,67,12,79,J2EE ,Pass,47,10,57,J2EE AND SOFTWARE TESTING LABORATORY,Pass,55,12,67,PROJECT AND VIVA VOCE ,Pass,170,52,222
M1611684, College : 4287  -  S.J.P.N.TRUST S B.C.A. COLLEGE  NIDASOSHI,DISTI,85.16,SOFTWARE PRACTICES AND TESTING ,Pass,68,16,84,BUSINESS INTELLIGENCE ,Pass,70,19,89,J2EE ,Pass,66,20,86,J2EE AND SOFTWARE TESTING LABORATORY,Pass,73,20,93,PROJECT AND VIVA VOCE ,Pass,225,58,283
M1611685, College : 4287  -  S.J.P.N.TRUST S B.C.A. COLLEGE  NIDASOSHI,DISTI,93.14,SOFTWARE PRACTICES AND TESTING ,Pass,77,20,97,BUSINESS INTELLIGENCE ,Pass,74,20,94,J2EE ,Pass,75,20,95,J2EE AND SOFTWARE TESTING LABORATORY,Pass,78,20,98,PROJECT AND VIVA VOCE ,Pass,235,58,293
M1611686, College : 4287  -  S.J.P.N.TRUST S B.C.A. COLLEGE  NIDASOSHI,N.C.L,--   ,SOFTWARE PRACTICES AND TESTING ,Pass,46,15,61,BUSINESS INTELLIGENCE ,Pass,32,15,47,J2EE ,Pass,41,15,56,J2EE AND SOFTWARE TESTING LABORATORY,Pass,45,15,60,PROJECT AND VIVA VOCE ,Pass,219,48,267
M1611687, College : 4287  -  S.J.P.N.TRUST S B.C.A. COLLEGE  NIDASOSHI,N.C.L,--   ,SOFTWARE PRACTICES AND TESTING ,Pass,64,10,74,BUSINESS INTELLIGENCE ,Pass,69,14,83,J2EE ,Pass,48,13,61,J2EE AND SOFTWARE TESTING LABORATORY,Pass,70,19,89,PROJECT AND VIVA VOCE ,Pass,220,57,277
M1611688, College : 4287  -  S.J.P.N.TRUST S B.C.A. COLLEGE  NIDASOSHI,DISTI,73.08,SOFTWARE PRACTICES AND TESTING ,Pass,54,11,65,BUSINESS INTELLIGENCE ,Pass,41,10,51,J2EE ,Pass,41,11,52,J2EE AND SOFTWARE TESTING LABORATORY,Pass,72,19,91,PROJECT AND VIVA VOCE ,Pass,233,58,291
M1611689, College : 4287  -  S.J.P.N.TRUST S B.C.A. COLLEGE  NIDASOSHI,N.C.L,--   ,SOFTWARE PRACTICES AND TESTING ,Pass,32,11,43,BUSINESS INTELLIGENCE ,Pass,43,15,58,J2EE ,Pass,32,8,40,J2EE AND SOFTWARE TESTING LABORATORY,Pass,62,15,77,PROJECT AND VIVA VOCE ,Pass,210,58,268
M1611690, College : 4287  -  S.J.P.N.TRUST S B.C.A. COLLEGE  NIDASOSHI,N.C.L,--   ,SOFTWARE PRACTICES AND TESTING ,Pass,39,8,47,BUSINESS INTELLIGENCE ,Pass,52,13,65,J2EE ,Pass,38,9,47,J2EE AND SOFTWARE TESTING LABORATORY,Pass,60,14,74,PROJECT AND VIVA VOCE ,Pass,205,55,260
M1611691, College : 4287  -  S.J.P.N.TRUST S B.C.A. COLLEGE  NIDASOSHI,DISTI,80.57,SOFTWARE PRACTICES AND TESTING ,Pass,67,12,79,BUSINESS INTELLIGENCE ,Pass,68,19,87,J2EE ,Pass,60,18,78,J2EE AND SOFTWARE TESTING LABORATORY,Pass,75,20,95,PROJECT AND VIVA VOCE ,Pass,230,55,285
M1611692, College : 4287  -  S.J.P.N.TRUST S B.C.A. COLLEGE  NIDASOSHI,N.C.L,--   ,SOFTWARE PRACTICES AND TESTING ,Pass,35,8,43,BUSINESS INTELLIGENCE ,Pass,47,10,57,J2EE ,Pass,37,9,46,J2EE AND SOFTWARE TESTING LABORATORY,Pass,55,9,64,PROJECT AND VIVA VOCE ,Pass,190,52,242
M1611693, College : 4287  -  S.J.P.N.TRUST S B.C.A. COLLEGE  NIDASOSHI,DISTI,72.54,SOFTWARE PRACTICES AND TESTING ,Pass,60,9,69,BUSINESS INTELLIGENCE ,Pass,72,16,88,J2EE ,Pass,57,13,70,J2EE AND SOFTWARE TESTING LABORATORY,Pass,57,16,73,PROJECT AND VIVA VOCE ,Pass,190,56,246
M1611694, College : 4287  -  S.J.P.N.TRUST S B.C.A. COLLEGE  NIDASOSHI,DISTI,87.7,SOFTWARE PRACTICES AND TESTING ,Pass,72,20,92,BUSINESS INTELLIGENCE ,Pass,77,19,96,J2EE ,Pass,66,20,86,J2EE AND SOFTWARE TESTING LABORATORY,Pass,74,20,94,PROJECT AND VIVA VOCE ,Pass,215,58,273
M1611695, College : 4287  -  S.J.P.N.TRUST S B.C.A. COLLEGE  NIDASOSHI,N.C.L,--   ,SOFTWARE PRACTICES AND TESTING ,Pass,49,8,57,BUSINESS INTELLIGENCE ,Pass,54,10,64,J2EE ,Pass,54,10,64,J2EE AND SOFTWARE TESTING LABORATORY,Pass,55,11,66,PROJECT AND VIVA VOCE ,Pass,198,51,249
M1611696, College : 4287  -  S.J.P.N.TRUST S B.C.A. COLLEGE  NIDASOSHI,DISTI,83.49,SOFTWARE PRACTICES AND TESTING ,Pass,65,17,82,BUSINESS INTELLIGENCE ,Pass,69,19,88,J2EE ,Pass,66,20,86,J2EE AND SOFTWARE TESTING LABORATORY,Pass,75,20,95,PROJECT AND VIVA VOCE ,Pass,225,58,283
M1611697, College : 4287  -  S.J.P.N.TRUST S B.C.A. COLLEGE  NIDASOSHI,DISTI,82.32,SOFTWARE PRACTICES AND TESTING ,Pass,64,16,80,BUSINESS INTELLIGENCE ,Pass,74,17,91,J2EE ,Pass,73,19,92,J2EE AND SOFTWARE TESTING LABORATORY,Pass,70,20,90,PROJECT AND VIVA VOCE ,Pass,215,58,273
M1611698, College : 4287  -  S.J.P.N.TRUST S B.C.A. COLLEGE  NIDASOSHI,DISTI,75.73,SOFTWARE PRACTICES AND TESTING ,Pass,51,15,66,BUSINESS INTELLIGENCE ,Pass,64,17,81,J2EE ,Pass,66,15,81,J2EE AND SOFTWARE TESTING LABORATORY,Pass,74,20,94,PROJECT AND VIVA VOCE ,Pass,220,55,275
M1611699, College : 4287  -  S.J.P.N.TRUST S B.C.A. COLLEGE  NIDASOSHI,DISTI,82.49,SOFTWARE PRACTICES AND TESTING ,Pass,67,17,84,BUSINESS INTELLIGENCE ,Pass,75,20,95,J2EE ,Pass,72,20,92,J2EE AND SOFTWARE TESTING LABORATORY,Pass,74,20,94,PROJECT AND VIVA VOCE ,Pass,223,55,278
M1611700, College : 4287  -  S.J.P.N.TRUST S B.C.A. COLLEGE  NIDASOSHI,DISTI,89,SOFTWARE PRACTICES AND TESTING ,Pass,67,18,85,BUSINESS INTELLIGENCE ,Pass,77,19,96,J2EE ,Pass,71,20,91,J2EE AND SOFTWARE TESTING LABORATORY,Pass,77,20,97,PROJECT AND VIVA VOCE ,Pass,230,56,286
M1611701, College : 4287  -  S.J.P.N.TRUST S B.C.A. COLLEGE  NIDASOSHI,N.C.L,--   ,SOFTWARE PRACTICES AND TESTING ,Pass,50,15,65,BUSINESS INTELLIGENCE ,Pass,37,15,52,J2EE ,Pass,39,15,54,J2EE AND SOFTWARE TESTING LABORATORY,Pass,34,15,49,PROJECT AND VIVA VOCE ,Pass,218,47,265
M1611702, College : 4287  -  S.J.P.N.TRUST S B.C.A. COLLEGE  NIDASOSHI,DISTI,79.49,SOFTWARE PRACTICES AND TESTING ,Pass,62,10,72,BUSINESS INTELLIGENCE ,Pass,69,19,88,J2EE ,Pass,60,15,75,J2EE AND SOFTWARE TESTING LABORATORY,Pass,73,19,92,PROJECT AND VIVA VOCE ,Pass,225,54,279
M1611703, College : 4287  -  S.J.P.N.TRUST S B.C.A. COLLEGE  NIDASOSHI,N.C.L,--   ,SOFTWARE PRACTICES AND TESTING ,Pass,50,15,65,BUSINESS INTELLIGENCE ,Pass,39,15,54,J2EE ,Pass,38,15,53,J2EE AND SOFTWARE TESTING LABORATORY,Pass,35,15,50,PROJECT AND VIVA VOCE ,Pass,210,46,256
M1611704, College : 4287  -  S.J.P.N.TRUST S B.C.A. COLLEGE  NIDASOSHI,DISTI,82.14,SOFTWARE PRACTICES AND TESTING ,Pass,50,11,61,BUSINESS INTELLIGENCE ,Pass,71,19,90,J2EE ,Pass,66,18,84,J2EE AND SOFTWARE TESTING LABORATORY,Pass,74,20,94,PROJECT AND VIVA VOCE ,Pass,210,55,265
M1611705, College : 4287  -  S.J.P.N.TRUST S B.C.A. COLLEGE  NIDASOSHI,DISTI,79.62,SOFTWARE PRACTICES AND TESTING ,Pass,42,10,52,BUSINESS INTELLIGENCE ,Pass,65,17,82,J2EE ,Pass,64,18,82,J2EE AND SOFTWARE TESTING LABORATORY,Pass,73,19,92,PROJECT AND VIVA VOCE ,Pass,225,58,283
M1611706, College : 4287  -  S.J.P.N.TRUST S B.C.A. COLLEGE  NIDASOSHI,1ST C,67.86,SOFTWARE PRACTICES AND TESTING ,Pass,47,15,62,BUSINESS INTELLIGENCE ,Pass,71,18,89,J2EE ,Pass,61,16,77,J2EE AND SOFTWARE TESTING LABORATORY,Pass,65,20,85,PROJECT AND VIVA VOCE ,Pass,210,56,266
M1611707, College : 4287  -  S.J.P.N.TRUST S B.C.A. COLLEGE  NIDASOSHI,DISTI,89.7,SOFTWARE PRACTICES AND TESTING ,Pass,59,16,75,BUSINESS INTELLIGENCE ,Pass,74,20,94,J2EE ,Pass,68,20,88,J2EE AND SOFTWARE TESTING LABORATORY,Pass,78,20,98,PROJECT AND VIVA VOCE ,Pass,233,60,293
M1611708, College : 4287  -  S.J.P.N.TRUST S B.C.A. COLLEGE  NIDASOSHI,FAIL,56,SOFTWARE PRACTICES AND TESTING ,Pass,43,4,47,BUSINESS INTELLIGENCE ,Fail,32,4,36,J2EE ,Pass,36,4,40,J2EE AND SOFTWARE TESTING LABORATORY,Pass,50,4,54,PROJECT AND VIVA VOCE ,Pass,185,30,215
M1611709, College : 4287  -  S.J.P.N.TRUST S B.C.A. COLLEGE  NIDASOSHI,DISTI,74.86,SOFTWARE PRACTICES AND TESTING ,Pass,60,15,75,BUSINESS INTELLIGENCE ,Pass,66,19,85,J2EE ,Pass,58,18,76,J2EE AND SOFTWARE TESTING LABORATORY,Pass,74,20,94,PROJECT AND VIVA VOCE ,Pass,225,58,283
M1611711, College : 4287  -  S.J.P.N.TRUST S B.C.A. COLLEGE  NIDASOSHI,DISTI,76.84,SOFTWARE PRACTICES AND TESTING ,Pass,42,15,57,BUSINESS INTELLIGENCE ,Pass,64,18,82,J2EE ,Pass,64,16,80,J2EE AND SOFTWARE TESTING LABORATORY,Pass,72,20,92,PROJECT AND VIVA VOCE ,Pass,220,51,271
M1611712, College : 4287  -  S.J.P.N.TRUST S B.C.A. COLLEGE  NIDASOSHI,DISTI,82.73,SOFTWARE PRACTICES AND TESTING ,Pass,65,15,80,BUSINESS INTELLIGENCE ,Pass,73,17,90,J2EE ,Pass,56,18,74,J2EE AND SOFTWARE TESTING LABORATORY,Pass,72,20,92,PROJECT AND VIVA VOCE ,Pass,225,58,283
M1611713, College : 4287  -  S.J.P.N.TRUST S B.C.A. COLLEGE  NIDASOSHI,DISTI,70.35,SOFTWARE PRACTICES AND TESTING ,Pass,63,13,76,BUSINESS INTELLIGENCE ,Pass,65,17,82,J2EE ,Pass,58,17,75,J2EE AND SOFTWARE TESTING LABORATORY,Pass,67,15,82,PROJECT AND VIVA VOCE ,Pass,215,55,270
M1611714, College : 4287  -  S.J.P.N.TRUST S B.C.A. COLLEGE  NIDASOSHI,DISTI,77.81,SOFTWARE PRACTICES AND TESTING ,Pass,53,14,67,BUSINESS INTELLIGENCE ,Pass,60,16,76,J2EE ,Pass,60,14,74,J2EE AND SOFTWARE TESTING LABORATORY,Pass,77,20,97,PROJECT AND VIVA VOCE ,Pass,230,51,281
M1611715, College : 4287  -  S.J.P.N.TRUST S B.C.A. COLLEGE  NIDASOSHI,DISTI,78.41,SOFTWARE PRACTICES AND TESTING ,Pass,51,16,67,BUSINESS INTELLIGENCE ,Pass,62,20,82,J2EE ,Pass,71,19,90,J2EE AND SOFTWARE TESTING LABORATORY,Pass,76,20,96,PROJECT AND VIVA VOCE ,Pass,230,55,285
M1611716, College : 4287  -  S.J.P.N.TRUST S B.C.A. COLLEGE  NIDASOSHI,N.C.L,--   ,SOFTWARE PRACTICES AND TESTING ,Pass,48,8,56,BUSINESS INTELLIGENCE ,Pass,33,9,42,J2EE ,Pass,36,8,44,J2EE AND SOFTWARE TESTING LABORATORY,Pass,44,9,53,PROJECT AND VIVA VOCE ,Pass,175,50,225
M1611717, College : 4287  -  S.J.P.N.TRUST S B.C.A. COLLEGE  NIDASOSHI,DISTI,80.27,SOFTWARE PRACTICES AND TESTING ,Pass,55,13,68,BUSINESS INTELLIGENCE ,Pass,55,19,74,J2EE ,Pass,53,16,69,J2EE AND SOFTWARE TESTING LABORATORY,Pass,77,20,97,PROJECT AND VIVA VOCE ,Pass,232,58,290
M1611718, College : 4287  -  S.J.P.N.TRUST S B.C.A. COLLEGE  NIDASOSHI,N.C.L,--   ,SOFTWARE PRACTICES AND TESTING ,Pass,47,8,55,BUSINESS INTELLIGENCE ,Pass,56,11,67,J2EE ,Pass,45,9,54,J2EE AND SOFTWARE TESTING LABORATORY,Pass,50,10,60,PROJECT AND VIVA VOCE ,Pass,200,52,252
M1611719, College : 4287  -  S.J.P.N.TRUST S B.C.A. COLLEGE  NIDASOSHI,1ST C,68.84,SOFTWARE PRACTICES AND TESTING ,Pass,57,9,66,BUSINESS INTELLIGENCE ,Pass,53,12,65,J2EE ,Pass,45,10,55,J2EE AND SOFTWARE TESTING LABORATORY,Pass,65,15,80,PROJECT AND VIVA VOCE ,Pass,205,54,259
M1611720, College : 4287  -  S.J.P.N.TRUST S B.C.A. COLLEGE  NIDASOSHI,N.C.L,--   ,SOFTWARE PRACTICES AND TESTING ,Pass,45,8,53,BUSINESS INTELLIGENCE ,Pass,52,10,62,J2EE ,Pass,38,8,46,J2EE AND SOFTWARE TESTING LABORATORY,Pass,42,11,53,PROJECT AND VIVA VOCE ,Pass,195,52,247
M1611801, College : 4289  -  V S M COLLEGE OF B.B.A. AND B.C.A.  NIPPANI,1ST C,64.65,SOFTWARE PRACTICES AND TESTING ,Pass,57,16,73,BUSINESS INTELLIGENCE ,Pass,41,16,57,J2EE ,Pass,42,16,58,J2EE AND SOFTWARE TESTING LABORATORY,Pass,55,16,71,PROJECT AND VIVA VOCE ,Pass,225,50,275
M1611802, College : 4289  -  V S M COLLEGE OF B.B.A. AND B.C.A.  NIPPANI,1ST C,65.16,SOFTWARE PRACTICES AND TESTING ,Pass,55,15,70,BUSINESS INTELLIGENCE ,Pass,41,16,57,J2EE ,Pass,42,16,58,J2EE AND SOFTWARE TESTING LABORATORY,Pass,52,16,68,PROJECT AND VIVA VOCE ,Pass,215,50,265
M1611803, College : 4289  -  V S M COLLEGE OF B.B.A. AND B.C.A.  NIPPANI,1ST C,69.08,SOFTWARE PRACTICES AND TESTING ,Pass,63,18,81,BUSINESS INTELLIGENCE ,Pass,45,17,62,J2EE ,Pass,49,17,66,J2EE AND SOFTWARE TESTING LABORATORY,Pass,58,16,74,PROJECT AND VIVA VOCE ,Pass,225,56,281
M1611804, College : 4289  -  V S M COLLEGE OF B.B.A. AND B.C.A.  NIPPANI,1ST C,61.11,SOFTWARE PRACTICES AND TESTING ,Pass,50,16,66,BUSINESS INTELLIGENCE ,Pass,38,16,54,J2EE ,Pass,39,16,55,J2EE AND SOFTWARE TESTING LABORATORY,Pass,34,16,50,PROJECT AND VIVA VOCE ,Pass,215,55,270
M1611805, College : 4289  -  V S M COLLEGE OF B.B.A. AND B.C.A.  NIPPANI,1ST C,69.16,SOFTWARE PRACTICES AND TESTING ,Pass,59,17,76,BUSINESS INTELLIGENCE ,Pass,43,18,61,J2EE ,Pass,45,18,63,J2EE AND SOFTWARE TESTING LABORATORY,Pass,72,17,89,PROJECT AND VIVA VOCE ,Pass,220,54,274
M1611806, College : 4289  -  V S M COLLEGE OF B.B.A. AND B.C.A.  NIPPANI,DISTI,72.68,SOFTWARE PRACTICES AND TESTING ,Pass,55,15,70,BUSINESS INTELLIGENCE ,Pass,47,18,65,J2EE ,Pass,48,17,65,J2EE AND SOFTWARE TESTING LABORATORY,Pass,68,16,84,PROJECT AND VIVA VOCE ,Pass,221,52,273
M1611808, College : 4289  -  V S M COLLEGE OF B.B.A. AND B.C.A.  NIPPANI,DISTI,71,SOFTWARE PRACTICES AND TESTING ,Pass,64,18,82,BUSINESS INTELLIGENCE ,Pass,39,18,57,J2EE ,Pass,48,17,65,J2EE AND SOFTWARE TESTING LABORATORY,Pass,70,18,88,PROJECT AND VIVA VOCE ,Pass,220,56,276
M1611809, College : 4289  -  V S M COLLEGE OF B.B.A. AND B.C.A.  NIPPANI,N.C.L,--   ,SOFTWARE PRACTICES AND TESTING ,Pass,64,16,80,BUSINESS INTELLIGENCE ,Pass,48,17,65,J2EE ,Pass,45,16,61,J2EE AND SOFTWARE TESTING LABORATORY,Pass,54,16,70,PROJECT AND VIVA VOCE ,Pass,215,52,267
M1611810, College : 4289  -  V S M COLLEGE OF B.B.A. AND B.C.A.  NIPPANI,N.C.L,--   ,SOFTWARE PRACTICES AND TESTING ,Pass,51,18,69,BUSINESS INTELLIGENCE ,Pass,32,18,50,J2EE ,Pass,45,17,62,J2EE AND SOFTWARE TESTING LABORATORY,Pass,70,19,89,PROJECT AND VIVA VOCE ,Pass,225,57,282
M1611811, College : 4289  -  V S M COLLEGE OF B.B.A. AND B.C.A.  NIPPANI,FAIL,70.29,SOFTWARE PRACTICES AND TESTING ,Pass,51,16,67,BUSINESS INTELLIGENCE ,Fail,19,16,35,J2EE ,Pass,44,16,60,J2EE AND SOFTWARE TESTING LABORATORY,Pass,52,16,68,PROJECT AND VIVA VOCE ,Pass,210,52,262
M1611812, College : 4289  -  V S M COLLEGE OF B.B.A. AND B.C.A.  NIPPANI,N.C.L,--   ,SOFTWARE PRACTICES AND TESTING ,Pass,44,15,59,BUSINESS INTELLIGENCE ,Pass,32,16,48,J2EE ,Pass,48,15,63,J2EE AND SOFTWARE TESTING LABORATORY,Pass,32,15,47,PROJECT AND VIVA VOCE ,Pass,225,52,277
M1611813, College : 4289  -  V S M COLLEGE OF B.B.A. AND B.C.A.  NIPPANI,FAIL,58.43,SOFTWARE PRACTICES AND TESTING ,Pass,43,15,58,BUSINESS INTELLIGENCE ,Fail,12,15,27,J2EE ,Pass,37,15,52,J2EE AND SOFTWARE TESTING LABORATORY,Pass,32,15,47,PROJECT AND VIVA VOCE ,Pass,180,45,225
M1611814, College : 4289  -  V S M COLLEGE OF B.B.A. AND B.C.A.  NIPPANI,DISTI,83.78,SOFTWARE PRACTICES AND TESTING ,Pass,65,19,84,BUSINESS INTELLIGENCE ,Pass,47,20,67,J2EE ,Pass,64,20,84,J2EE AND SOFTWARE TESTING LABORATORY,Pass,76,20,96,PROJECT AND VIVA VOCE ,Pass,237,59,296
M1611815, College : 4289  -  V S M COLLEGE OF B.B.A. AND B.C.A.  NIPPANI,N.C.L,--   ,SOFTWARE PRACTICES AND TESTING ,Pass,47,18,65,BUSINESS INTELLIGENCE ,Pass,32,20,52,J2EE ,Pass,42,20,62,J2EE AND SOFTWARE TESTING LABORATORY,Pass,78,20,98,PROJECT AND VIVA VOCE ,Pass,220,59,279
M1611816, College : 4289  -  V S M COLLEGE OF B.B.A. AND B.C.A.  NIPPANI,DISTI,80.89,SOFTWARE PRACTICES AND TESTING ,Pass,56,19,75,BUSINESS INTELLIGENCE ,Pass,47,20,67,J2EE ,Pass,59,20,79,J2EE AND SOFTWARE TESTING LABORATORY,Pass,74,20,94,PROJECT AND VIVA VOCE ,Pass,237,59,296
M1611817, College : 4289  -  V S M COLLEGE OF B.B.A. AND B.C.A.  NIPPANI,N.C.L,--   ,SOFTWARE PRACTICES AND TESTING ,Pass,36,16,52,BUSINESS INTELLIGENCE ,Pass,40,16,56,J2EE ,Pass,44,16,60,J2EE AND SOFTWARE TESTING LABORATORY,Pass,32,16,48,PROJECT AND VIVA VOCE ,Pass,210,52,262
M1611818, College : 4289  -  V S M COLLEGE OF B.B.A. AND B.C.A.  NIPPANI,N.C.L,--   ,SOFTWARE PRACTICES AND TESTING ,Pass,51,16,67,BUSINESS INTELLIGENCE ,Pass,42,15,57,J2EE ,Pass,40,15,55,J2EE AND SOFTWARE TESTING LABORATORY,Pass,50,15,65,PROJECT AND VIVA VOCE ,Pass,220,54,274
M1611821, College : 4289  -  V S M COLLEGE OF B.B.A. AND B.C.A.  NIPPANI,N.C.L,--   ,SOFTWARE PRACTICES AND TESTING ,Pass,47,16,63,BUSINESS INTELLIGENCE ,Pass,43,16,59,J2EE ,Pass,33,16,49,J2EE AND SOFTWARE TESTING LABORATORY,Pass,65,16,81,PROJECT AND VIVA VOCE ,Pass,210,53,263
M1611822, College : 4289  -  V S M COLLEGE OF B.B.A. AND B.C.A.  NIPPANI,N.C.L,--   ,SOFTWARE PRACTICES AND TESTING ,Pass,45,15,60,BUSINESS INTELLIGENCE ,Pass,50,15,65,J2EE ,Pass,53,16,69,J2EE AND SOFTWARE TESTING LABORATORY,Pass,72,16,88,PROJECT AND VIVA VOCE ,Pass,236,52,288
M1611826, College : 4289  -  V S M COLLEGE OF B.B.A. AND B.C.A.  NIPPANI,N.C.L,--   ,SOFTWARE PRACTICES AND TESTING ,Pass,48,15,63,BUSINESS INTELLIGENCE ,Pass,62,19,81,J2EE ,Pass,54,19,73,J2EE AND SOFTWARE TESTING LABORATORY,Pass,54,19,73,PROJECT AND VIVA VOCE ,Pass,220,59,279
M1611827, College : 4289  -  V S M COLLEGE OF B.B.A. AND B.C.A.  NIPPANI,N.C.L,--   ,SOFTWARE PRACTICES AND TESTING ,Pass,50,18,68,BUSINESS INTELLIGENCE ,Pass,57,18,75,J2EE ,Pass,44,18,62,J2EE AND SOFTWARE TESTING LABORATORY,Pass,70,18,88,PROJECT AND VIVA VOCE ,Pass,225,57,282
M1611828, College : 4289  -  V S M COLLEGE OF B.B.A. AND B.C.A.  NIPPANI,N.C.L,--   ,SOFTWARE PRACTICES AND TESTING ,Pass,37,16,53,BUSINESS INTELLIGENCE ,Pass,40,17,57,J2EE ,Pass,39,17,56,J2EE AND SOFTWARE TESTING LABORATORY,Pass,58,16,74,PROJECT AND VIVA VOCE ,Pass,220,53,273
M1611829, College : 4289  -  V S M COLLEGE OF B.B.A. AND B.C.A.  NIPPANI,N.C.L,--   ,SOFTWARE PRACTICES AND TESTING ,Pass,48,16,64,BUSINESS INTELLIGENCE ,Pass,32,16,48,J2EE ,Pass,45,15,60,J2EE AND SOFTWARE TESTING LABORATORY,Pass,50,15,65,PROJECT AND VIVA VOCE ,Pass,215,50,265
M1611830, College : 4289  -  V S M COLLEGE OF B.B.A. AND B.C.A.  NIPPANI,FAIL,55.29,SOFTWARE PRACTICES AND TESTING ,Fail,19,16,35,BUSINESS INTELLIGENCE ,Fail,8,16,24,J2EE ,Pass,32,16,48,J2EE AND SOFTWARE TESTING LABORATORY,Pass,32,16,48,PROJECT AND VIVA VOCE ,Pass,180,52,232
M1611831, College : 4289  -  V S M COLLEGE OF B.B.A. AND B.C.A.  NIPPANI,FAIL,58.14,SOFTWARE PRACTICES AND TESTING ,Pass,34,15,49,BUSINESS INTELLIGENCE ,Pass,32,16,48,J2EE ,Fail,23,15,38,J2EE AND SOFTWARE TESTING LABORATORY,Pass,32,15,47,PROJECT AND VIVA VOCE ,Pass,180,45,225
M1611832, College : 4289  -  V S M COLLEGE OF B.B.A. AND B.C.A.  NIPPANI,DISTI,78.68,SOFTWARE PRACTICES AND TESTING ,Pass,68,18,86,BUSINESS INTELLIGENCE ,Pass,41,19,60,J2EE ,Pass,33,17,50,J2EE AND SOFTWARE TESTING LABORATORY,Pass,76,18,94,PROJECT AND VIVA VOCE ,Pass,225,58,283
M1611833, College : 4289  -  V S M COLLEGE OF B.B.A. AND B.C.A.  NIPPANI,N.C.L,--   ,SOFTWARE PRACTICES AND TESTING ,Pass,49,16,65,BUSINESS INTELLIGENCE ,Pass,33,16,49,J2EE ,Pass,32,16,48,J2EE AND SOFTWARE TESTING LABORATORY,Pass,56,16,72,PROJECT AND VIVA VOCE ,Pass,215,52,267
M1611834, College : 4289  -  V S M COLLEGE OF B.B.A. AND B.C.A.  NIPPANI,FAIL,61.86,SOFTWARE PRACTICES AND TESTING ,Pass,49,15,64,BUSINESS INTELLIGENCE ,Fail,18,16,34,J2EE ,Pass,39,16,55,J2EE AND SOFTWARE TESTING LABORATORY,Pass,32,16,48,PROJECT AND VIVA VOCE ,Pass,180,52,232
M1611835, College : 4289  -  V S M COLLEGE OF B.B.A. AND B.C.A.  NIPPANI,DISTI,79.7,SOFTWARE PRACTICES AND TESTING ,Pass,56,18,74,BUSINESS INTELLIGENCE ,Pass,46,20,66,J2EE ,Pass,50,20,70,J2EE AND SOFTWARE TESTING LABORATORY,Pass,78,20,98,PROJECT AND VIVA VOCE ,Pass,215,59,274
M1611837, College : 4289  -  V S M COLLEGE OF B.B.A. AND B.C.A.  NIPPANI,FAIL,47.14,SOFTWARE PRACTICES AND TESTING ,Fail,0,15,15,BUSINESS INTELLIGENCE ,Fail,8,15,23,J2EE ,Fail,15,15,30,J2EE AND SOFTWARE TESTING LABORATORY,Pass,32,15,47,PROJECT AND VIVA VOCE ,Pass,170,45,215
M1611838, College : 4289  -  V S M COLLEGE OF B.B.A. AND B.C.A.  NIPPANI,FAIL,47.86,SOFTWARE PRACTICES AND TESTING ,Pass,34,15,49,BUSINESS INTELLIGENCE ,Fail,16,15,31,J2EE ,Fail,Ab.,15,15,J2EE AND SOFTWARE TESTING LABORATORY,Fail,Ab.,15,15,PROJECT AND VIVA VOCE ,Pass,180,45,225
M1611839, College : 4289  -  V S M COLLEGE OF B.B.A. AND B.C.A.  NIPPANI,N.C.L,--   ,SOFTWARE PRACTICES AND TESTING ,Pass,54,16,70,BUSINESS INTELLIGENCE ,Pass,38,19,57,J2EE ,Pass,54,20,74,J2EE AND SOFTWARE TESTING LABORATORY,Pass,79,20,99,PROJECT AND VIVA VOCE ,Pass,215,57,272
M1611840, College : 4289  -  V S M COLLEGE OF B.B.A. AND B.C.A.  NIPPANI,N.C.L,--   ,SOFTWARE PRACTICES AND TESTING ,Pass,38,16,54,BUSINESS INTELLIGENCE ,Pass,32,16,48,J2EE ,Pass,45,16,61,J2EE AND SOFTWARE TESTING LABORATORY,Pass,58,16,74,PROJECT AND VIVA VOCE ,Pass,210,54,264
M1611841, College : 4289  -  V S M COLLEGE OF B.B.A. AND B.C.A.  NIPPANI,FAIL,67.29,SOFTWARE PRACTICES AND TESTING ,Pass,34,16,50,BUSINESS INTELLIGENCE ,Fail,19,16,35,J2EE ,Pass,38,16,54,J2EE AND SOFTWARE TESTING LABORATORY,Pass,48,16,64,PROJECT AND VIVA VOCE ,Pass,215,53,268
M1611842, College : 4289  -  V S M COLLEGE OF B.B.A. AND B.C.A.  NIPPANI,FAIL,58.43,SOFTWARE PRACTICES AND TESTING ,Pass,36,15,51,BUSINESS INTELLIGENCE ,Fail,17,15,32,J2EE ,Pass,32,15,47,J2EE AND SOFTWARE TESTING LABORATORY,Pass,32,15,47,PROJECT AND VIVA VOCE ,Pass,180,52,232
M1611844, College : 4289  -  V S M COLLEGE OF B.B.A. AND B.C.A.  NIPPANI,DISTI,74.16,SOFTWARE PRACTICES AND TESTING ,Pass,46,17,63,BUSINESS INTELLIGENCE ,Pass,32,20,52,J2EE ,Pass,45,20,65,J2EE AND SOFTWARE TESTING LABORATORY,Pass,72,20,92,PROJECT AND VIVA VOCE ,Pass,225,58,283
M1611845, College : 4289  -  V S M COLLEGE OF B.B.A. AND B.C.A.  NIPPANI,DISTI,77.46,SOFTWARE PRACTICES AND TESTING ,Pass,52,18,70,BUSINESS INTELLIGENCE ,Pass,42,20,62,J2EE ,Pass,48,20,68,J2EE AND SOFTWARE TESTING LABORATORY,Pass,78,20,98,PROJECT AND VIVA VOCE ,Pass,235,59,294
M1611847, College : 4289  -  V S M COLLEGE OF B.B.A. AND B.C.A.  NIPPANI,DISTI,72.38,SOFTWARE PRACTICES AND TESTING ,Pass,54,18,72,BUSINESS INTELLIGENCE ,Pass,47,18,65,J2EE ,Pass,52,16,68,J2EE AND SOFTWARE TESTING LABORATORY,Pass,65,16,81,PROJECT AND VIVA VOCE ,Pass,220,56,276
M1611848, College : 4289  -  V S M COLLEGE OF B.B.A. AND B.C.A.  NIPPANI,N.C.L,--   ,SOFTWARE PRACTICES AND TESTING ,Pass,39,18,57,BUSINESS INTELLIGENCE ,Pass,44,17,61,J2EE ,Pass,38,15,53,J2EE AND SOFTWARE TESTING LABORATORY,Pass,62,16,78,PROJECT AND VIVA VOCE ,Pass,215,55,270
M1611849, College : 4289  -  V S M COLLEGE OF B.B.A. AND B.C.A.  NIPPANI,FAIL,63.57,SOFTWARE PRACTICES AND TESTING ,Pass,35,18,53,BUSINESS INTELLIGENCE ,Pass,35,17,52,J2EE ,Fail,19,16,35,J2EE AND SOFTWARE TESTING LABORATORY,Pass,32,16,48,PROJECT AND VIVA VOCE ,Pass,200,57,257
M1611850, College : 4289  -  V S M COLLEGE OF B.B.A. AND B.C.A.  NIPPANI,DISTI,73.27,SOFTWARE PRACTICES AND TESTING ,Pass,47,18,65,BUSINESS INTELLIGENCE ,Pass,40,20,60,J2EE ,Pass,35,20,55,J2EE AND SOFTWARE TESTING LABORATORY,Pass,68,20,88,PROJECT AND VIVA VOCE ,Pass,230,59,289
M1611851, College : 4289  -  V S M COLLEGE OF B.B.A. AND B.C.A.  NIPPANI,N.C.L,--   ,SOFTWARE PRACTICES AND TESTING ,Pass,40,18,58,BUSINESS INTELLIGENCE ,Pass,54,18,72,J2EE ,Pass,35,17,52,J2EE AND SOFTWARE TESTING LABORATORY,Pass,79,19,98,PROJECT AND VIVA VOCE ,Pass,220,59,279
M1611852, College : 4289  -  V S M COLLEGE OF B.B.A. AND B.C.A.  NIPPANI,N.C.L,--   ,SOFTWARE PRACTICES AND TESTING ,Pass,33,15,48,BUSINESS INTELLIGENCE ,Pass,32,16,48,J2EE ,Pass,39,15,54,J2EE AND SOFTWARE TESTING LABORATORY,Pass,38,15,53,PROJECT AND VIVA VOCE ,Pass,210,50,260
M1611853, College : 4289  -  V S M COLLEGE OF B.B.A. AND B.C.A.  NIPPANI,1ST C,61.7,SOFTWARE PRACTICES AND TESTING ,Pass,34,17,51,BUSINESS INTELLIGENCE ,Pass,36,16,52,J2EE ,Pass,41,16,57,J2EE AND SOFTWARE TESTING LABORATORY,Pass,36,16,52,PROJECT AND VIVA VOCE ,Pass,210,52,262
M1611854, College : 4289  -  V S M COLLEGE OF B.B.A. AND B.C.A.  NIPPANI,N.C.L,--   ,SOFTWARE PRACTICES AND TESTING ,Pass,53,15,68,BUSINESS INTELLIGENCE ,Pass,43,16,59,J2EE ,Pass,44,15,59,J2EE AND SOFTWARE TESTING LABORATORY,Pass,78,16,94,PROJECT AND VIVA VOCE ,Pass,215,52,267
M1611855, College : 4289  -  V S M COLLEGE OF B.B.A. AND B.C.A.  NIPPANI,N.C.L,--   ,SOFTWARE PRACTICES AND TESTING ,Pass,32,15,47,BUSINESS INTELLIGENCE ,Pass,34,17,51,J2EE ,Pass,40,16,56,J2EE AND SOFTWARE TESTING LABORATORY,Pass,72,16,88,PROJECT AND VIVA VOCE ,Pass,210,52,262
M1611856, College : 4289  -  V S M COLLEGE OF B.B.A. AND B.C.A.  NIPPANI,N.C.L,--   ,SOFTWARE PRACTICES AND TESTING ,Pass,32,15,47,BUSINESS INTELLIGENCE ,Pass,46,16,62,J2EE ,Pass,33,15,48,J2EE AND SOFTWARE TESTING LABORATORY,Pass,60,16,76,PROJECT AND VIVA VOCE ,Pass,180,52,232
M1611857, College : 4289  -  V S M COLLEGE OF B.B.A. AND B.C.A.  NIPPANI,DISTI,76.78,SOFTWARE PRACTICES AND TESTING ,Pass,40,18,58,BUSINESS INTELLIGENCE ,Pass,55,18,73,J2EE ,Pass,41,17,58,J2EE AND SOFTWARE TESTING LABORATORY,Pass,70,18,88,PROJECT AND VIVA VOCE ,Pass,230,58,288
M1611858, College : 4289  -  V S M COLLEGE OF B.B.A. AND B.C.A.  NIPPANI,N.C.L,--   ,SOFTWARE PRACTICES AND TESTING ,Pass,47,17,64,BUSINESS INTELLIGENCE ,Pass,37,19,56,J2EE ,Pass,51,18,69,J2EE AND SOFTWARE TESTING LABORATORY,Pass,68,18,86,PROJECT AND VIVA VOCE ,Pass,230,56,286
M1611859, College : 4289  -  V S M COLLEGE OF B.B.A. AND B.C.A.  NIPPANI,N.C.L,--   ,SOFTWARE PRACTICES AND TESTING ,Pass,53,17,70,BUSINESS INTELLIGENCE ,Pass,41,19,60,J2EE ,Pass,43,18,61,J2EE AND SOFTWARE TESTING LABORATORY,Pass,78,18,96,PROJECT AND VIVA VOCE ,Pass,215,55,270
M1611862, College : 4289  -  V S M COLLEGE OF B.B.A. AND B.C.A.  NIPPANI,N.C.L,--   ,SOFTWARE PRACTICES AND TESTING ,Pass,45,16,61,BUSINESS INTELLIGENCE ,Pass,34,18,52,J2EE ,Pass,45,17,62,J2EE AND SOFTWARE TESTING LABORATORY,Pass,70,16,86,PROJECT AND VIVA VOCE ,Pass,220,55,275
M1611864, College : 4289  -  V S M COLLEGE OF B.B.A. AND B.C.A.  NIPPANI,N.C.L,--   ,SOFTWARE PRACTICES AND TESTING ,Pass,42,16,58,BUSINESS INTELLIGENCE ,Pass,36,19,55,J2EE ,Pass,32,17,49,J2EE AND SOFTWARE TESTING LABORATORY,Pass,72,16,88,PROJECT AND VIVA VOCE ,Pass,215,50,265
M1611865, College : 4289  -  V S M COLLEGE OF B.B.A. AND B.C.A.  NIPPANI,N.C.L,--   ,SOFTWARE PRACTICES AND TESTING ,Pass,37,15,52,BUSINESS INTELLIGENCE ,Pass,40,16,56,J2EE ,Pass,32,15,47,J2EE AND SOFTWARE TESTING LABORATORY,Pass,32,15,47,PROJECT AND VIVA VOCE ,Pass,180,45,225
M1611866, College : 4289  -  V S M COLLEGE OF B.B.A. AND B.C.A.  NIPPANI,N.C.L,--   ,SOFTWARE PRACTICES AND TESTING ,Pass,36,18,54,BUSINESS INTELLIGENCE ,Pass,38,18,56,J2EE ,Pass,32,18,50,J2EE AND SOFTWARE TESTING LABORATORY,Pass,32,17,49,PROJECT AND VIVA VOCE ,Pass,215,57,272
M1611868, College : 4289  -  V S M COLLEGE OF B.B.A. AND B.C.A.  NIPPANI,N.C.L,--   ,SOFTWARE PRACTICES AND TESTING ,Pass,41,16,57,BUSINESS INTELLIGENCE ,Pass,38,16,54,J2EE ,Pass,32,16,48,J2EE AND SOFTWARE TESTING LABORATORY,Pass,68,15,83,PROJECT AND VIVA VOCE ,Pass,215,52,267
M1611869, College : 4289  -  V S M COLLEGE OF B.B.A. AND B.C.A.  NIPPANI,1ST C,66.46,SOFTWARE PRACTICES AND TESTING ,Pass,45,16,61,BUSINESS INTELLIGENCE ,Pass,48,16,64,J2EE ,Pass,32,16,48,J2EE AND SOFTWARE TESTING LABORATORY,Pass,70,15,85,PROJECT AND VIVA VOCE ,Pass,210,53,263
M1611870, College : 4289  -  V S M COLLEGE OF B.B.A. AND B.C.A.  NIPPANI,1ST C,60,SOFTWARE PRACTICES AND TESTING ,Pass,33,16,49,BUSINESS INTELLIGENCE ,Pass,35,16,51,J2EE ,Pass,32,16,48,J2EE AND SOFTWARE TESTING LABORATORY,Pass,55,15,70,PROJECT AND VIVA VOCE ,Pass,190,52,242
M1611871, College : 4289  -  V S M COLLEGE OF B.B.A. AND B.C.A.  NIPPANI,N.C.L,--   ,SOFTWARE PRACTICES AND TESTING ,Pass,47,18,65,BUSINESS INTELLIGENCE ,Pass,45,18,63,J2EE ,Pass,32,18,50,J2EE AND SOFTWARE TESTING LABORATORY,Pass,70,17,87,PROJECT AND VIVA VOCE ,Pass,225,57,282
M1611872, College : 4289  -  V S M COLLEGE OF B.B.A. AND B.C.A.  NIPPANI,N.C.L,--   ,SOFTWARE PRACTICES AND TESTING ,Pass,34,17,51,BUSINESS INTELLIGENCE ,Pass,41,16,57,J2EE ,Pass,32,16,48,J2EE AND SOFTWARE TESTING LABORATORY,Pass,72,16,88,PROJECT AND VIVA VOCE ,Pass,210,53,263
M1611873, College : 4289  -  V S M COLLEGE OF B.B.A. AND B.C.A.  NIPPANI,DISTI,72.95,SOFTWARE PRACTICES AND TESTING ,Pass,48,16,64,BUSINESS INTELLIGENCE ,Pass,45,16,61,J2EE ,Pass,48,16,64,J2EE AND SOFTWARE TESTING LABORATORY,Pass,75,16,91,PROJECT AND VIVA VOCE ,Pass,215,52,267
M1611874, College : 4289  -  V S M COLLEGE OF B.B.A. AND B.C.A.  NIPPANI,N.C.L,--   ,SOFTWARE PRACTICES AND TESTING ,Pass,39,16,55,BUSINESS INTELLIGENCE ,Pass,45,16,61,J2EE ,Pass,32,15,47,J2EE AND SOFTWARE TESTING LABORATORY,Pass,40,16,56,PROJECT AND VIVA VOCE ,Pass,210,50,260
M1611875, College : 4289  -  V S M COLLEGE OF B.B.A. AND B.C.A.  NIPPANI,N.C.L,--   ,SOFTWARE PRACTICES AND TESTING ,Pass,32,16,48,BUSINESS INTELLIGENCE ,Pass,45,16,61,J2EE ,Pass,32,15,47,J2EE AND SOFTWARE TESTING LABORATORY,Pass,40,16,56,PROJECT AND VIVA VOCE ,Pass,210,50,260
M1611876, College : 4289  -  V S M COLLEGE OF B.B.A. AND B.C.A.  NIPPANI,N.C.L,--   ,SOFTWARE PRACTICES AND TESTING ,Pass,36,17,53,BUSINESS INTELLIGENCE ,Pass,43,18,61,J2EE ,Pass,33,17,50,J2EE AND SOFTWARE TESTING LABORATORY,Pass,75,17,92,PROJECT AND VIVA VOCE ,Pass,220,56,276
M1611877, College : 4289  -  V S M COLLEGE OF B.B.A. AND B.C.A.  NIPPANI,1ST C,69.54,SOFTWARE PRACTICES AND TESTING ,Pass,42,18,60,BUSINESS INTELLIGENCE ,Pass,50,18,68,J2EE ,Pass,40,18,58,J2EE AND SOFTWARE TESTING LABORATORY,Pass,70,18,88,PROJECT AND VIVA VOCE ,Pass,225,57,282
M1611878, College : 4289  -  V S M COLLEGE OF B.B.A. AND B.C.A.  NIPPANI,N.C.L,--   ,SOFTWARE PRACTICES AND TESTING ,Pass,34,17,51,BUSINESS INTELLIGENCE ,Pass,42,17,59,J2EE ,Pass,32,16,48,J2EE AND SOFTWARE TESTING LABORATORY,Pass,36,17,53,PROJECT AND VIVA VOCE ,Pass,200,56,256
M1611879, College : 4289  -  V S M COLLEGE OF B.B.A. AND B.C.A.  NIPPANI,DISTI,71.49,SOFTWARE PRACTICES AND TESTING ,Pass,32,16,48,BUSINESS INTELLIGENCE ,Pass,38,17,55,J2EE ,Pass,37,16,53,J2EE AND SOFTWARE TESTING LABORATORY,Pass,60,16,76,PROJECT AND VIVA VOCE ,Pass,215,54,269
M1611880, College : 4289  -  V S M COLLEGE OF B.B.A. AND B.C.A.  NIPPANI,DISTI,76.73,SOFTWARE PRACTICES AND TESTING ,Pass,51,18,69,BUSINESS INTELLIGENCE ,Pass,56,17,73,J2EE ,Pass,47,18,65,J2EE AND SOFTWARE TESTING LABORATORY,Pass,65,19,84,PROJECT AND VIVA VOCE ,Pass,215,57,272
M1611881, College : 4289  -  V S M COLLEGE OF B.B.A. AND B.C.A.  NIPPANI,1ST C,68.89,SOFTWARE PRACTICES AND TESTING ,Pass,43,18,61,BUSINESS INTELLIGENCE ,Pass,40,18,58,J2EE ,Pass,37,18,55,J2EE AND SOFTWARE TESTING LABORATORY,Pass,55,18,73,PROJECT AND VIVA VOCE ,Pass,225,58,283
M1611882, College : 4289  -  V S M COLLEGE OF B.B.A. AND B.C.A.  NIPPANI,1ST C,63.03,SOFTWARE PRACTICES AND TESTING ,Pass,42,16,58,BUSINESS INTELLIGENCE ,Pass,40,17,57,J2EE ,Pass,39,15,54,J2EE AND SOFTWARE TESTING LABORATORY,Pass,38,16,54,PROJECT AND VIVA VOCE ,Pass,190,52,242
M1611884, College : 4289  -  V S M COLLEGE OF B.B.A. AND B.C.A.  NIPPANI,N.C.L,--   ,SOFTWARE PRACTICES AND TESTING ,Pass,44,16,60,BUSINESS INTELLIGENCE ,Pass,38,18,56,J2EE ,Pass,40,17,57,J2EE AND SOFTWARE TESTING LABORATORY,Pass,40,17,57,PROJECT AND VIVA VOCE ,Pass,215,57,272
M1611885, College : 4289  -  V S M COLLEGE OF B.B.A. AND B.C.A.  NIPPANI,N.C.L,--   ,SOFTWARE PRACTICES AND TESTING ,Pass,44,16,60,BUSINESS INTELLIGENCE ,Pass,40,18,58,J2EE ,Pass,34,17,51,J2EE AND SOFTWARE TESTING LABORATORY,Pass,58,17,75,PROJECT AND VIVA VOCE ,Pass,225,56,281
M1611886, College : 4289  -  V S M COLLEGE OF B.B.A. AND B.C.A.  NIPPANI,N.C.L,--   ,SOFTWARE PRACTICES AND TESTING ,Pass,44,15,59,BUSINESS INTELLIGENCE ,Pass,39,16,55,J2EE ,Pass,38,16,54,J2EE AND SOFTWARE TESTING LABORATORY,Pass,56,16,72,PROJECT AND VIVA VOCE ,Pass,210,50,260
M1611887, College : 4289  -  V S M COLLEGE OF B.B.A. AND B.C.A.  NIPPANI,DISTI,80,SOFTWARE PRACTICES AND TESTING ,Pass,54,17,71,BUSINESS INTELLIGENCE ,Pass,57,19,76,J2EE ,Pass,47,20,67,J2EE AND SOFTWARE TESTING LABORATORY,Pass,79,18,97,PROJECT AND VIVA VOCE ,Pass,215,58,273
M1611888, College : 4289  -  V S M COLLEGE OF B.B.A. AND B.C.A.  NIPPANI,N.C.L,--   ,SOFTWARE PRACTICES AND TESTING ,Pass,42,15,57,BUSINESS INTELLIGENCE ,Pass,33,17,50,J2EE ,Pass,32,16,48,J2EE AND SOFTWARE TESTING LABORATORY,Pass,38,17,55,PROJECT AND VIVA VOCE ,Pass,190,50,240
M1611889, College : 4289  -  V S M COLLEGE OF B.B.A. AND B.C.A.  NIPPANI,FAIL,54.86,SOFTWARE PRACTICES AND TESTING ,Pass,32,15,47,BUSINESS INTELLIGENCE ,Fail,15,16,31,J2EE ,Fail,12,16,28,J2EE AND SOFTWARE TESTING LABORATORY,Pass,32,16,48,PROJECT AND VIVA VOCE ,Pass,180,50,230
M1611890, College : 4289  -  V S M COLLEGE OF B.B.A. AND B.C.A.  NIPPANI,FAIL,53.14,SOFTWARE PRACTICES AND TESTING ,Pass,32,15,47,BUSINESS INTELLIGENCE ,Pass,32,16,48,J2EE ,Fail,22,15,37,J2EE AND SOFTWARE TESTING LABORATORY,Fail,Ab.,15,15,PROJECT AND VIVA VOCE ,Pass,180,45,225
M1611891, College : 4289  -  V S M COLLEGE OF B.B.A. AND B.C.A.  NIPPANI,DISTI,77.54,SOFTWARE PRACTICES AND TESTING ,Pass,54,18,72,BUSINESS INTELLIGENCE ,Pass,45,20,65,J2EE ,Pass,54,20,74,J2EE AND SOFTWARE TESTING LABORATORY,Pass,74,20,94,PROJECT AND VIVA VOCE ,Pass,230,59,289
M1611892, College : 4289  -  V S M COLLEGE OF B.B.A. AND B.C.A.  NIPPANI,N.C.L,--   ,SOFTWARE PRACTICES AND TESTING ,Pass,33,16,49,BUSINESS INTELLIGENCE ,Pass,32,16,48,J2EE ,Pass,32,16,48,J2EE AND SOFTWARE TESTING LABORATORY,Pass,32,16,48,PROJECT AND VIVA VOCE ,Pass,210,52,262
M1611894, College : 4289  -  V S M COLLEGE OF B.B.A. AND B.C.A.  NIPPANI,N.C.L,--   ,SOFTWARE PRACTICES AND TESTING ,Pass,45,18,63,BUSINESS INTELLIGENCE ,Pass,35,18,53,J2EE ,Pass,42,18,60,J2EE AND SOFTWARE TESTING LABORATORY,Pass,74,18,92,PROJECT AND VIVA VOCE ,Pass,235,57,292
M1611895, College : 4289  -  V S M COLLEGE OF B.B.A. AND B.C.A.  NIPPANI,N.C.L,--   ,SOFTWARE PRACTICES AND TESTING ,Pass,38,17,55,BUSINESS INTELLIGENCE ,Pass,41,19,60,J2EE ,Pass,39,16,55,J2EE AND SOFTWARE TESTING LABORATORY,Pass,56,17,73,PROJECT AND VIVA VOCE ,Pass,210,52,262
M1611896, College : 4289  -  V S M COLLEGE OF B.B.A. AND B.C.A.  NIPPANI,DISTI,77.22,SOFTWARE PRACTICES AND TESTING ,Pass,62,16,78,BUSINESS INTELLIGENCE ,Pass,58,18,76,J2EE ,Pass,49,18,67,J2EE AND SOFTWARE TESTING LABORATORY,Pass,76,16,92,PROJECT AND VIVA VOCE ,Pass,230,54,284
M1611897, College : 4289  -  V S M COLLEGE OF B.B.A. AND B.C.A.  NIPPANI,DISTI,76.78,SOFTWARE PRACTICES AND TESTING ,Pass,57,18,75,BUSINESS INTELLIGENCE ,Pass,56,19,75,J2EE ,Pass,57,17,74,J2EE AND SOFTWARE TESTING LABORATORY,Pass,74,19,93,PROJECT AND VIVA VOCE ,Pass,215,57,272
M1611898, College : 4289  -  V S M COLLEGE OF B.B.A. AND B.C.A.  NIPPANI,N.C.L,--   ,SOFTWARE PRACTICES AND TESTING ,Pass,32,16,48,BUSINESS INTELLIGENCE ,Pass,45,16,61,J2EE ,Pass,42,16,58,J2EE AND SOFTWARE TESTING LABORATORY,Pass,40,15,55,PROJECT AND VIVA VOCE ,Pass,180,45,225
M1611899, College : 4289  -  V S M COLLEGE OF B.B.A. AND B.C.A.  NIPPANI,N.C.L,--   ,SOFTWARE PRACTICES AND TESTING ,Pass,32,15,47,BUSINESS INTELLIGENCE ,Pass,50,16,66,J2EE ,Pass,38,16,54,J2EE AND SOFTWARE TESTING LABORATORY,Pass,38,15,53,PROJECT AND VIVA VOCE ,Pass,185,50,235
M1612001, College : 4293  -  KLE S G I BAGEVADI B.C.A. COLLEGE  NIPPANI,FAIL,58.14,SOFTWARE PRACTICES AND TESTING ,Pass,32,8,40,BUSINESS INTELLIGENCE ,Pass,33,12,45,J2EE ,Fail,17,15,32,J2EE AND SOFTWARE TESTING LABORATORY,Pass,50,15,65,PROJECT AND VIVA VOCE ,Pass,180,45,225
M1612002, College : 4293  -  KLE S G I BAGEVADI B.C.A. COLLEGE  NIPPANI,DISTI,82.24,SOFTWARE PRACTICES AND TESTING ,Pass,62,18,80,BUSINESS INTELLIGENCE ,Pass,57,19,76,J2EE ,Pass,42,19,61,J2EE AND SOFTWARE TESTING LABORATORY,Pass,72,20,92,PROJECT AND VIVA VOCE ,Pass,238,58,296
M1612004, College : 4293  -  KLE S G I BAGEVADI B.C.A. COLLEGE  NIPPANI,FAIL,66.14,SOFTWARE PRACTICES AND TESTING ,Pass,50,13,63,BUSINESS INTELLIGENCE ,Pass,32,16,48,J2EE ,Fail,22,16,38,J2EE AND SOFTWARE TESTING LABORATORY,Pass,59,15,74,PROJECT AND VIVA VOCE ,Pass,200,40,240
M1612005, College : 4293  -  KLE S G I BAGEVADI B.C.A. COLLEGE  NIPPANI,N.C.L,--   ,SOFTWARE PRACTICES AND TESTING ,Pass,48,8,56,BUSINESS INTELLIGENCE ,Pass,58,15,73,J2EE ,Pass,32,15,47,J2EE AND SOFTWARE TESTING LABORATORY,Pass,55,15,70,PROJECT AND VIVA VOCE ,Pass,190,40,230
M1612006, College : 4293  -  KLE S G I BAGEVADI B.C.A. COLLEGE  NIPPANI,DISTI,86.95,SOFTWARE PRACTICES AND TESTING ,Pass,55,18,73,BUSINESS INTELLIGENCE ,Pass,65,18,83,J2EE ,Pass,59,18,77,J2EE AND SOFTWARE TESTING LABORATORY,Pass,77,20,97,PROJECT AND VIVA VOCE ,Pass,230,57,287
M1612007, College : 4293  -  KLE S G I BAGEVADI B.C.A. COLLEGE  NIPPANI,N.C.L,--   ,SOFTWARE PRACTICES AND TESTING ,Pass,47,18,65,BUSINESS INTELLIGENCE ,Pass,47,17,64,J2EE ,Pass,59,17,76,J2EE AND SOFTWARE TESTING LABORATORY,Pass,73,14,87,PROJECT AND VIVA VOCE ,Pass,220,55,275
M1612008, College : 4293  -  KLE S G I BAGEVADI B.C.A. COLLEGE  NIPPANI,N.C.L,--   ,SOFTWARE PRACTICES AND TESTING ,Pass,53,15,68,BUSINESS INTELLIGENCE ,Pass,47,16,63,J2EE ,Pass,57,16,73,J2EE AND SOFTWARE TESTING LABORATORY,Pass,52,15,67,PROJECT AND VIVA VOCE ,Pass,210,45,255
M1612010, College : 4293  -  KLE S G I BAGEVADI B.C.A. COLLEGE  NIPPANI,N.C.L,--   ,SOFTWARE PRACTICES AND TESTING ,Pass,50,18,68,BUSINESS INTELLIGENCE ,Pass,51,16,67,J2EE ,Pass,33,16,49,J2EE AND SOFTWARE TESTING LABORATORY,Pass,50,15,65,PROJECT AND VIVA VOCE ,Pass,200,50,250
M1612011, College : 4293  -  KLE S G I BAGEVADI B.C.A. COLLEGE  NIPPANI,1ST C,67.51,SOFTWARE PRACTICES AND TESTING ,Pass,45,15,60,BUSINESS INTELLIGENCE ,Pass,45,17,62,J2EE ,Pass,46,17,63,J2EE AND SOFTWARE TESTING LABORATORY,Pass,75,18,93,PROJECT AND VIVA VOCE ,Pass,235,57,292
M1612012, College : 4293  -  KLE S G I BAGEVADI B.C.A. COLLEGE  NIPPANI,1ST C,65.35,SOFTWARE PRACTICES AND TESTING ,Pass,42,14,56,BUSINESS INTELLIGENCE ,Pass,47,14,61,J2EE ,Pass,41,14,55,J2EE AND SOFTWARE TESTING LABORATORY,Pass,59,14,73,PROJECT AND VIVA VOCE ,Pass,200,40,240
M1612013, College : 4293  -  KLE S G I BAGEVADI B.C.A. COLLEGE  NIPPANI,1ST C,68.19,SOFTWARE PRACTICES AND TESTING ,Pass,40,14,54,BUSINESS INTELLIGENCE ,Pass,46,17,63,J2EE ,Pass,43,17,60,J2EE AND SOFTWARE TESTING LABORATORY,Pass,72,18,90,PROJECT AND VIVA VOCE ,Pass,210,54,264
M1612014, College : 4293  -  KLE S G I BAGEVADI B.C.A. COLLEGE  NIPPANI,FAIL,46,SOFTWARE PRACTICES AND TESTING ,Pass,40,8,48,BUSINESS INTELLIGENCE ,Fail,18,8,26,J2EE ,Pass,32,8,40,J2EE AND SOFTWARE TESTING LABORATORY,Pass,40,8,48,PROJECT AND VIVA VOCE ,Pass,120,40,160
M1612015, College : 4293  -  KLE S G I BAGEVADI B.C.A. COLLEGE  NIPPANI,N.C.L,--   ,SOFTWARE PRACTICES AND TESTING ,Pass,48,8,56,BUSINESS INTELLIGENCE ,Pass,32,8,40,J2EE ,Pass,32,8,40,J2EE AND SOFTWARE TESTING LABORATORY,Pass,40,8,48,PROJECT AND VIVA VOCE ,Pass,120,40,160
M1612017, College : 4293  -  KLE S G I BAGEVADI B.C.A. COLLEGE  NIPPANI,N.C.L,--   ,SOFTWARE PRACTICES AND TESTING ,Pass,54,12,66,BUSINESS INTELLIGENCE ,Pass,33,17,50,J2EE ,Pass,36,17,53,J2EE AND SOFTWARE TESTING LABORATORY,Pass,59,17,76,PROJECT AND VIVA VOCE ,Pass,190,53,243
M1612019, College : 4293  -  KLE S G I BAGEVADI B.C.A. COLLEGE  NIPPANI,DISTI,76,SOFTWARE PRACTICES AND TESTING ,Pass,66,15,81,BUSINESS INTELLIGENCE ,Pass,51,17,68,J2EE ,Pass,50,17,67,J2EE AND SOFTWARE TESTING LABORATORY,Pass,78,17,95,PROJECT AND VIVA VOCE ,Pass,235,60,295
M1612020, College : 4293  -  KLE S G I BAGEVADI B.C.A. COLLEGE  NIPPANI,DISTI,71.11,SOFTWARE PRACTICES AND TESTING ,Pass,63,15,78,BUSINESS INTELLIGENCE ,Pass,51,16,67,J2EE ,Pass,49,16,65,J2EE AND SOFTWARE TESTING LABORATORY,Pass,55,15,70,PROJECT AND VIVA VOCE ,Pass,210,40,250
M1612022, College : 4293  -  KLE S G I BAGEVADI B.C.A. COLLEGE  NIPPANI,DISTI,81.81,SOFTWARE PRACTICES AND TESTING ,Pass,74,17,91,BUSINESS INTELLIGENCE ,Pass,62,20,82,J2EE ,Pass,64,20,84,J2EE AND SOFTWARE TESTING LABORATORY,Pass,76,20,96,PROJECT AND VIVA VOCE ,Pass,225,60,285
M1612023, College : 4293  -  KLE S G I BAGEVADI B.C.A. COLLEGE  NIPPANI,FAIL,71.86,SOFTWARE PRACTICES AND TESTING ,Pass,32,12,44,BUSINESS INTELLIGENCE ,Pass,32,17,49,J2EE ,Fail,22,17,39,J2EE AND SOFTWARE TESTING LABORATORY,Pass,76,17,93,PROJECT AND VIVA VOCE ,Pass,220,58,278
M1612024, College : 4293  -  KLE S G I BAGEVADI B.C.A. COLLEGE  NIPPANI,FAIL,42.29,SOFTWARE PRACTICES AND TESTING ,Fail,14,8,22,BUSINESS INTELLIGENCE ,Fail,15,10,25,J2EE ,Fail,15,10,25,J2EE AND SOFTWARE TESTING LABORATORY,Pass,42,12,54,PROJECT AND VIVA VOCE ,Pass,120,50,170
M1612025, College : 4293  -  KLE S G I BAGEVADI B.C.A. COLLEGE  NIPPANI,DISTI,78.43,SOFTWARE PRACTICES AND TESTING ,Pass,63,16,79,BUSINESS INTELLIGENCE ,Pass,57,19,76,J2EE ,Pass,37,19,56,J2EE AND SOFTWARE TESTING LABORATORY,Pass,73,18,91,PROJECT AND VIVA VOCE ,Pass,230,56,286
M1612026, College : 4293  -  KLE S G I BAGEVADI B.C.A. COLLEGE  NIPPANI,FAIL,73.43,SOFTWARE PRACTICES AND TESTING ,Pass,44,12,56,BUSINESS INTELLIGENCE ,Pass,42,17,59,J2EE ,Fail,16,17,33,J2EE AND SOFTWARE TESTING LABORATORY,Pass,76,17,93,PROJECT AND VIVA VOCE ,Pass,215,58,273
M1612027, College : 4293  -  KLE S G I BAGEVADI B.C.A. COLLEGE  NIPPANI,FAIL,61.86,SOFTWARE PRACTICES AND TESTING ,Pass,47,10,57,BUSINESS INTELLIGENCE ,Pass,35,14,49,J2EE ,Fail,13,14,27,J2EE AND SOFTWARE TESTING LABORATORY,Pass,45,15,60,PROJECT AND VIVA VOCE ,Pass,200,40,240
M1612028, College : 4293  -  KLE S G I BAGEVADI B.C.A. COLLEGE  NIPPANI,DISTI,71.49,SOFTWARE PRACTICES AND TESTING ,Pass,52,15,67,BUSINESS INTELLIGENCE ,Pass,45,17,62,J2EE ,Pass,42,17,59,J2EE AND SOFTWARE TESTING LABORATORY,Pass,72,17,89,PROJECT AND VIVA VOCE ,Pass,200,55,255
M1612029, College : 4293  -  KLE S G I BAGEVADI B.C.A. COLLEGE  NIPPANI,FAIL,32.14,SOFTWARE PRACTICES AND TESTING ,Fail,6,8,14,BUSINESS INTELLIGENCE ,Fail,15,8,23,J2EE ,Fail,12,8,20,J2EE AND SOFTWARE TESTING LABORATORY,Fail,Ab.,8,8,PROJECT AND VIVA VOCE ,Pass,120,40,160
M1612030, College : 4293  -  KLE S G I BAGEVADI B.C.A. COLLEGE  NIPPANI,DISTI,91.57,SOFTWARE PRACTICES AND TESTING ,Pass,78,20,98,BUSINESS INTELLIGENCE ,Pass,67,20,87,J2EE ,Pass,71,20,91,J2EE AND SOFTWARE TESTING LABORATORY,Pass,79,20,99,PROJECT AND VIVA VOCE ,Pass,240,60,300
M1612031, College : 4293  -  KLE S G I BAGEVADI B.C.A. COLLEGE  NIPPANI,N.C.L,--   ,SOFTWARE PRACTICES AND TESTING ,Pass,47,11,58,BUSINESS INTELLIGENCE ,Pass,38,10,48,J2EE ,Pass,32,10,42,J2EE AND SOFTWARE TESTING LABORATORY,Pass,47,12,59,PROJECT AND VIVA VOCE ,Pass,180,45,225
M1612032, College : 4293  -  KLE S G I BAGEVADI B.C.A. COLLEGE  NIPPANI,DISTI,84.54,SOFTWARE PRACTICES AND TESTING ,Pass,65,20,85,BUSINESS INTELLIGENCE ,Pass,53,19,72,J2EE ,Pass,45,19,64,J2EE AND SOFTWARE TESTING LABORATORY,Pass,79,20,99,PROJECT AND VIVA VOCE ,Pass,238,60,298
M1612033, College : 4293  -  KLE S G I BAGEVADI B.C.A. COLLEGE  NIPPANI,FAIL,45.71,SOFTWARE PRACTICES AND TESTING ,Pass,32,8,40,BUSINESS INTELLIGENCE ,Pass,33,13,46,J2EE ,Fail,19,13,32,J2EE AND SOFTWARE TESTING LABORATORY,Pass,40,12,52,PROJECT AND VIVA VOCE ,Pass,105,45,150
M1612034, College : 4293  -  KLE S G I BAGEVADI B.C.A. COLLEGE  NIPPANI,DISTI,77.35,SOFTWARE PRACTICES AND TESTING ,Pass,71,15,86,BUSINESS INTELLIGENCE ,Pass,59,14,73,J2EE ,Pass,32,14,46,J2EE AND SOFTWARE TESTING LABORATORY,Pass,58,15,73,PROJECT AND VIVA VOCE ,Pass,230,50,280
M1612035, College : 4293  -  KLE S G I BAGEVADI B.C.A. COLLEGE  NIPPANI,FAIL,68.14,SOFTWARE PRACTICES AND TESTING ,Pass,61,12,73,BUSINESS INTELLIGENCE ,Pass,55,14,69,J2EE ,Fail,21,14,35,J2EE AND SOFTWARE TESTING LABORATORY,Pass,56,14,70,PROJECT AND VIVA VOCE ,Pass,190,40,230
M1612036, College : 4293  -  KLE S G I BAGEVADI B.C.A. COLLEGE  NIPPANI,DISTI,73.86,SOFTWARE PRACTICES AND TESTING ,Pass,65,15,80,BUSINESS INTELLIGENCE ,Pass,50,18,68,J2EE ,Pass,32,18,50,J2EE AND SOFTWARE TESTING LABORATORY,Pass,76,17,93,PROJECT AND VIVA VOCE ,Pass,220,55,275
M1612037, College : 4293  -  KLE S G I BAGEVADI B.C.A. COLLEGE  NIPPANI,FAIL,79.29,SOFTWARE PRACTICES AND TESTING ,Pass,60,18,78,BUSINESS INTELLIGENCE ,Pass,58,17,75,J2EE ,Fail,20,17,37,J2EE AND SOFTWARE TESTING LABORATORY,Pass,56,16,72,PROJECT AND VIVA VOCE ,Pass,238,55,293
M1612038, College : 4293  -  KLE S G I BAGEVADI B.C.A. COLLEGE  NIPPANI,DISTI,72.43,SOFTWARE PRACTICES AND TESTING ,Pass,63,17,80,BUSINESS INTELLIGENCE ,Pass,64,19,83,J2EE ,Pass,32,19,51,J2EE AND SOFTWARE TESTING LABORATORY,Pass,74,20,94,PROJECT AND VIVA VOCE ,Pass,220,57,277
M1612039, College : 4293  -  KLE S G I BAGEVADI B.C.A. COLLEGE  NIPPANI,DISTI,84.32,SOFTWARE PRACTICES AND TESTING ,Pass,64,20,84,BUSINESS INTELLIGENCE ,Pass,68,17,85,J2EE ,Pass,41,17,58,J2EE AND SOFTWARE TESTING LABORATORY,Pass,76,18,94,PROJECT AND VIVA VOCE ,Pass,238,60,298
M1612040, College : 4293  -  KLE S G I BAGEVADI B.C.A. COLLEGE  NIPPANI,DISTI,79.27,SOFTWARE PRACTICES AND TESTING ,Pass,57,15,72,BUSINESS INTELLIGENCE ,Pass,53,19,72,J2EE ,Pass,39,19,58,J2EE AND SOFTWARE TESTING LABORATORY,Pass,77,19,96,PROJECT AND VIVA VOCE ,Pass,220,60,280
M1612041, College : 4293  -  KLE S G I BAGEVADI B.C.A. COLLEGE  NIPPANI,FAIL,56.57,SOFTWARE PRACTICES AND TESTING ,Pass,45,8,53,BUSINESS INTELLIGENCE ,Fail,16,8,24,J2EE ,Pass,32,8,40,J2EE AND SOFTWARE TESTING LABORATORY,Pass,51,8,59,PROJECT AND VIVA VOCE ,Pass,180,40,220
M1612042, College : 4293  -  KLE S G I BAGEVADI B.C.A. COLLEGE  NIPPANI,N.C.L,--   ,SOFTWARE PRACTICES AND TESTING ,Pass,53,12,65,BUSINESS INTELLIGENCE ,Pass,37,10,47,J2EE ,Pass,32,10,42,J2EE AND SOFTWARE TESTING LABORATORY,Pass,55,14,69,PROJECT AND VIVA VOCE ,Pass,200,52,252
M1612043, College : 4293  -  KLE S G I BAGEVADI B.C.A. COLLEGE  NIPPANI,N.C.L,--   ,SOFTWARE PRACTICES AND TESTING ,Pass,40,12,52,BUSINESS INTELLIGENCE ,Pass,35,16,51,J2EE ,Pass,32,16,48,J2EE AND SOFTWARE TESTING LABORATORY,Pass,42,16,58,PROJECT AND VIVA VOCE ,Pass,220,50,270
M1612044, College : 4293  -  KLE S G I BAGEVADI B.C.A. COLLEGE  NIPPANI,DISTI,82.49,SOFTWARE PRACTICES AND TESTING ,Pass,65,18,83,BUSINESS INTELLIGENCE ,Pass,52,17,69,J2EE ,Pass,42,17,59,J2EE AND SOFTWARE TESTING LABORATORY,Pass,75,19,94,PROJECT AND VIVA VOCE ,Pass,230,58,288
M1612045, College : 4293  -  KLE S G I BAGEVADI B.C.A. COLLEGE  NIPPANI,DISTI,81.03,SOFTWARE PRACTICES AND TESTING ,Pass,66,17,83,BUSINESS INTELLIGENCE ,Pass,55,18,73,J2EE ,Pass,40,18,58,J2EE AND SOFTWARE TESTING LABORATORY,Pass,78,19,97,PROJECT AND VIVA VOCE ,Pass,200,55,255
M1612046, College : 4293  -  KLE S G I BAGEVADI B.C.A. COLLEGE  NIPPANI,DISTI,77.86,SOFTWARE PRACTICES AND TESTING ,Pass,63,16,79,BUSINESS INTELLIGENCE ,Pass,56,17,73,J2EE ,Pass,32,17,49,J2EE AND SOFTWARE TESTING LABORATORY,Pass,71,18,89,PROJECT AND VIVA VOCE ,Pass,220,58,278
M1612047, College : 4293  -  KLE S G I BAGEVADI B.C.A. COLLEGE  NIPPANI,N.C.L,--   ,SOFTWARE PRACTICES AND TESTING ,Pass,32,8,40,BUSINESS INTELLIGENCE ,Pass,40,12,52,J2EE ,Pass,32,12,44,J2EE AND SOFTWARE TESTING LABORATORY,Pass,35,8,43,PROJECT AND VIVA VOCE ,Pass,105,40,145
M1612048, College : 4293  -  KLE S G I BAGEVADI B.C.A. COLLEGE  NIPPANI,DISTI,77.38,SOFTWARE PRACTICES AND TESTING ,Pass,51,20,71,BUSINESS INTELLIGENCE ,Pass,51,18,69,J2EE ,Pass,33,18,51,J2EE AND SOFTWARE TESTING LABORATORY,Pass,78,19,97,PROJECT AND VIVA VOCE ,Pass,230,60,290
M1612049, College : 4293  -  KLE S G I BAGEVADI B.C.A. COLLEGE  NIPPANI,FAIL,38.29,SOFTWARE PRACTICES AND TESTING ,Pass,32,8,40,BUSINESS INTELLIGENCE ,Pass,43,8,51,J2EE ,Fail,16,8,24,J2EE AND SOFTWARE TESTING LABORATORY,Fail,Ab.,8,8,PROJECT AND VIVA VOCE ,Pass,105,40,145
M1612050, College : 4293  -  KLE S G I BAGEVADI B.C.A. COLLEGE  NIPPANI,FAIL,39.14,SOFTWARE PRACTICES AND TESTING ,Fail,11,8,19,BUSINESS INTELLIGENCE ,Pass,40,8,48,J2EE ,Fail,11,8,19,J2EE AND SOFTWARE TESTING LABORATORY,Pass,35,8,43,PROJECT AND VIVA VOCE ,Pass,105,40,145
M1612052, College : 4293  -  KLE S G I BAGEVADI B.C.A. COLLEGE  NIPPANI,DISTI,75.05,SOFTWARE PRACTICES AND TESTING ,Pass,71,16,87,BUSINESS INTELLIGENCE ,Pass,60,19,79,J2EE ,Pass,38,19,57,J2EE AND SOFTWARE TESTING LABORATORY,Pass,77,20,97,PROJECT AND VIVA VOCE ,Pass,220,56,276
M1612053, College : 4293  -  KLE S G I BAGEVADI B.C.A. COLLEGE  NIPPANI,FAIL,73.71,SOFTWARE PRACTICES AND TESTING ,Pass,52,14,66,BUSINESS INTELLIGENCE ,Pass,50,14,64,J2EE ,Fail,22,14,36,J2EE AND SOFTWARE TESTING LABORATORY,Pass,60,15,75,PROJECT AND VIVA VOCE ,Pass,220,55,275
M1612054, College : 4293  -  KLE S G I BAGEVADI B.C.A. COLLEGE  NIPPANI,DISTI,81.95,SOFTWARE PRACTICES AND TESTING ,Pass,62,16,78,BUSINESS INTELLIGENCE ,Pass,50,18,68,J2EE ,Pass,34,18,52,J2EE AND SOFTWARE TESTING LABORATORY,Pass,78,19,97,PROJECT AND VIVA VOCE ,Pass,220,55,275
M1612055, College : 4293  -  KLE S G I BAGEVADI B.C.A. COLLEGE  NIPPANI,N.C.L,--   ,SOFTWARE PRACTICES AND TESTING ,Pass,37,10,47,BUSINESS INTELLIGENCE ,Pass,32,12,44,J2EE ,Pass,32,12,44,J2EE AND SOFTWARE TESTING LABORATORY,Pass,60,13,73,PROJECT AND VIVA VOCE ,Pass,105,40,145
M1612056, College : 4293  -  KLE S G I BAGEVADI B.C.A. COLLEGE  NIPPANI,FAIL,37.43,SOFTWARE PRACTICES AND TESTING ,Fail,4,8,12,BUSINESS INTELLIGENCE ,Pass,32,8,40,J2EE ,Fail,14,8,22,J2EE AND SOFTWARE TESTING LABORATORY,Pass,35,8,43,PROJECT AND VIVA VOCE ,Pass,105,40,145
M1612057, College : 4293  -  KLE S G I BAGEVADI B.C.A. COLLEGE  NIPPANI,FAIL,41.57,SOFTWARE PRACTICES AND TESTING ,Fail,19,8,27,BUSINESS INTELLIGENCE ,Pass,32,8,40,J2EE ,Fail,16,8,24,J2EE AND SOFTWARE TESTING LABORATORY,Pass,32,8,40,PROJECT AND VIVA VOCE ,Pass,120,40,160
M1612058, College : 4293  -  KLE S G I BAGEVADI B.C.A. COLLEGE  NIPPANI,N.C.L,--   ,SOFTWARE PRACTICES AND TESTING ,Pass,49,11,60,BUSINESS INTELLIGENCE ,Pass,49,12,61,J2EE ,Pass,32,12,44,J2EE AND SOFTWARE TESTING LABORATORY,Pass,60,13,73,PROJECT AND VIVA VOCE ,Pass,200,55,255
M1612060, College : 4293  -  KLE S G I BAGEVADI B.C.A. COLLEGE  NIPPANI,DISTI,86.35,SOFTWARE PRACTICES AND TESTING ,Pass,70,19,89,BUSINESS INTELLIGENCE ,Pass,65,20,85,J2EE ,Pass,71,18,89,J2EE AND SOFTWARE TESTING LABORATORY,Pass,75,19,94,PROJECT AND VIVA VOCE ,Pass,225,55,280
M1612061, College : 4293  -  KLE S G I BAGEVADI B.C.A. COLLEGE  NIPPANI,FAIL,54.14,SOFTWARE PRACTICES AND TESTING ,Fail,17,8,25,BUSINESS INTELLIGENCE ,Pass,33,8,41,J2EE ,Pass,32,8,40,J2EE AND SOFTWARE TESTING LABORATORY,Pass,40,8,48,PROJECT AND VIVA VOCE ,Pass,180,45,225
M1612063, College : 4293  -  KLE S G I BAGEVADI B.C.A. COLLEGE  NIPPANI,N.C.L,--   ,SOFTWARE PRACTICES AND TESTING ,Pass,32,8,40,BUSINESS INTELLIGENCE ,Pass,50,8,58,J2EE ,Pass,34,8,42,J2EE AND SOFTWARE TESTING LABORATORY,Pass,35,8,43,PROJECT AND VIVA VOCE ,Pass,160,52,212
M1612064, College : 4293  -  KLE S G I BAGEVADI B.C.A. COLLEGE  NIPPANI,N.C.L,--   ,SOFTWARE PRACTICES AND TESTING ,Pass,35,12,47,BUSINESS INTELLIGENCE ,Pass,56,14,70,J2EE ,Pass,37,14,51,J2EE AND SOFTWARE TESTING LABORATORY,Pass,58,13,71,PROJECT AND VIVA VOCE ,Pass,180,45,225
M1612066, College : 4293  -  KLE S G I BAGEVADI B.C.A. COLLEGE  NIPPANI,DISTI,83.46,SOFTWARE PRACTICES AND TESTING ,Pass,63,18,81,BUSINESS INTELLIGENCE ,Pass,61,18,79,J2EE ,Pass,59,18,77,J2EE AND SOFTWARE TESTING LABORATORY,Pass,76,20,96,PROJECT AND VIVA VOCE ,Pass,230,59,289
M1612067, College : 4293  -  KLE S G I BAGEVADI B.C.A. COLLEGE  NIPPANI,DISTI,79.24,SOFTWARE PRACTICES AND TESTING ,Pass,58,15,73,BUSINESS INTELLIGENCE ,Pass,57,17,74,J2EE ,Pass,60,17,77,J2EE AND SOFTWARE TESTING LABORATORY,Pass,70,18,88,PROJECT AND VIVA VOCE ,Pass,210,55,265
M1612068, College : 4293  -  KLE S G I BAGEVADI B.C.A. COLLEGE  NIPPANI,DISTI,77.03,SOFTWARE PRACTICES AND TESTING ,Pass,57,16,73,BUSINESS INTELLIGENCE ,Pass,73,18,91,J2EE ,Pass,50,18,68,J2EE AND SOFTWARE TESTING LABORATORY,Pass,75,19,94,PROJECT AND VIVA VOCE ,Pass,220,56,276
M1612069, College : 4293  -  KLE S G I BAGEVADI B.C.A. COLLEGE  NIPPANI,FAIL,49.14,SOFTWARE PRACTICES AND TESTING ,Pass,40,8,48,BUSINESS INTELLIGENCE ,Pass,35,8,43,J2EE ,Fail,2,8,10,J2EE AND SOFTWARE TESTING LABORATORY,Pass,35,8,43,PROJECT AND VIVA VOCE ,Pass,160,40,200
M1612070, College : 4293  -  KLE S G I BAGEVADI B.C.A. COLLEGE  NIPPANI,FAIL,48,SOFTWARE PRACTICES AND TESTING ,Pass,33,8,41,BUSINESS INTELLIGENCE ,Pass,56,8,64,J2EE ,Fail,22,8,30,J2EE AND SOFTWARE TESTING LABORATORY,Pass,40,8,48,PROJECT AND VIVA VOCE ,Pass,105,48,153
M1612071, College : 4293  -  KLE S G I BAGEVADI B.C.A. COLLEGE  NIPPANI,DISTI,71.19,SOFTWARE PRACTICES AND TESTING ,Pass,57,16,73,BUSINESS INTELLIGENCE ,Pass,57,17,74,J2EE ,Pass,46,17,63,J2EE AND SOFTWARE TESTING LABORATORY,Pass,74,18,92,PROJECT AND VIVA VOCE ,Pass,200,55,255
M1612072, College : 4293  -  KLE S G I BAGEVADI B.C.A. COLLEGE  NIPPANI,N.C.L,--   ,SOFTWARE PRACTICES AND TESTING ,Pass,44,15,59,BUSINESS INTELLIGENCE ,Pass,45,15,60,J2EE ,Pass,34,15,49,J2EE AND SOFTWARE TESTING LABORATORY,Pass,71,15,86,PROJECT AND VIVA VOCE ,Pass,235,55,290
M1612073, College : 4293  -  KLE S G I BAGEVADI B.C.A. COLLEGE  NIPPANI,FAIL,42.57,SOFTWARE PRACTICES AND TESTING ,Fail,10,8,18,BUSINESS INTELLIGENCE ,Pass,50,12,62,J2EE ,Fail,19,12,31,J2EE AND SOFTWARE TESTING LABORATORY,Pass,32,10,42,PROJECT AND VIVA VOCE ,Pass,105,40,145
M1612074, College : 4293  -  KLE S G I BAGEVADI B.C.A. COLLEGE  NIPPANI,N.C.L,--   ,SOFTWARE PRACTICES AND TESTING ,Pass,32,8,40,BUSINESS INTELLIGENCE ,Pass,51,8,59,J2EE ,Pass,32,8,40,J2EE AND SOFTWARE TESTING LABORATORY,Pass,32,8,40,PROJECT AND VIVA VOCE ,Pass,120,45,165
M1612075, College : 4293  -  KLE S G I BAGEVADI B.C.A. COLLEGE  NIPPANI,1ST C,67.62,SOFTWARE PRACTICES AND TESTING ,Pass,43,14,57,BUSINESS INTELLIGENCE ,Pass,52,17,69,J2EE ,Pass,38,17,55,J2EE AND SOFTWARE TESTING LABORATORY,Pass,75,17,92,PROJECT AND VIVA VOCE ,Pass,200,57,257
M1612076, College : 4293  -  KLE S G I BAGEVADI B.C.A. COLLEGE  NIPPANI,DISTI,71.92,SOFTWARE PRACTICES AND TESTING ,Pass,47,15,62,BUSINESS INTELLIGENCE ,Pass,60,17,77,J2EE ,Pass,48,17,65,J2EE AND SOFTWARE TESTING LABORATORY,Pass,76,17,93,PROJECT AND VIVA VOCE ,Pass,225,55,280
M1612077, College : 4293  -  KLE S G I BAGEVADI B.C.A. COLLEGE  NIPPANI,FAIL,41,SOFTWARE PRACTICES AND TESTING ,Fail,4,8,12,BUSINESS INTELLIGENCE ,Pass,41,8,49,J2EE ,Fail,18,8,26,J2EE AND SOFTWARE TESTING LABORATORY,Pass,32,8,40,PROJECT AND VIVA VOCE ,Pass,120,40,160
M1612201, College : 4306  -  SDVVS S B.C.A. COLLEGE  SANKESHWAR,DISTI,82.22,SOFTWARE PRACTICES AND TESTING ,Pass,68,15,83,BUSINESS INTELLIGENCE ,Pass,45,19,64,J2EE ,Pass,61,18,79,J2EE AND SOFTWARE TESTING LABORATORY,Pass,79,18,97,PROJECT AND VIVA VOCE ,Pass,235,59,294
M1612202, College : 4306  -  SDVVS S B.C.A. COLLEGE  SANKESHWAR,DISTI,77.92,SOFTWARE PRACTICES AND TESTING ,Pass,60,18,78,BUSINESS INTELLIGENCE ,Pass,45,19,64,J2EE ,Pass,60,19,79,J2EE AND SOFTWARE TESTING LABORATORY,Pass,78,20,98,PROJECT AND VIVA VOCE ,Pass,236,58,294
M1612204, College : 4306  -  SDVVS S B.C.A. COLLEGE  SANKESHWAR,1ST C,69.49,SOFTWARE PRACTICES AND TESTING ,Pass,42,17,59,BUSINESS INTELLIGENCE ,Pass,39,18,57,J2EE ,Pass,52,18,70,J2EE AND SOFTWARE TESTING LABORATORY,Pass,71,18,89,PROJECT AND VIVA VOCE ,Pass,215,54,269
M1612206, College : 4306  -  SDVVS S B.C.A. COLLEGE  SANKESHWAR,DISTI,72.57,SOFTWARE PRACTICES AND TESTING ,Pass,43,16,59,BUSINESS INTELLIGENCE ,Pass,32,19,51,J2EE ,Pass,51,17,68,J2EE AND SOFTWARE TESTING LABORATORY,Pass,72,17,89,PROJECT AND VIVA VOCE ,Pass,210,52,262
M1612207, College : 4306  -  SDVVS S B.C.A. COLLEGE  SANKESHWAR,N.C.L,--   ,SOFTWARE PRACTICES AND TESTING ,Pass,32,13,45,BUSINESS INTELLIGENCE ,Pass,32,18,50,J2EE ,Pass,36,11,47,J2EE AND SOFTWARE TESTING LABORATORY,Pass,69,16,85,PROJECT AND VIVA VOCE ,Pass,205,50,255
M1612209, College : 4306  -  SDVVS S B.C.A. COLLEGE  SANKESHWAR,N.C.L,--   ,SOFTWARE PRACTICES AND TESTING ,Pass,33,15,48,BUSINESS INTELLIGENCE ,Pass,33,18,51,J2EE ,Pass,40,12,52,J2EE AND SOFTWARE TESTING LABORATORY,Pass,68,17,85,PROJECT AND VIVA VOCE ,Pass,207,50,257
M1612210, College : 4306  -  SDVVS S B.C.A. COLLEGE  SANKESHWAR,DISTI,85.51,SOFTWARE PRACTICES AND TESTING ,Pass,64,20,84,BUSINESS INTELLIGENCE ,Pass,60,19,79,J2EE ,Pass,57,20,77,J2EE AND SOFTWARE TESTING LABORATORY,Pass,77,20,97,PROJECT AND VIVA VOCE ,Pass,232,58,290
M1612212, College : 4306  -  SDVVS S B.C.A. COLLEGE  SANKESHWAR,N.C.L,--   ,SOFTWARE PRACTICES AND TESTING ,Pass,45,16,61,BUSINESS INTELLIGENCE ,Pass,41,19,60,J2EE ,Pass,36,17,53,J2EE AND SOFTWARE TESTING LABORATORY,Pass,75,17,92,PROJECT AND VIVA VOCE ,Pass,212,52,264
M1612213, College : 4306  -  SDVVS S B.C.A. COLLEGE  SANKESHWAR,DISTI,74.89,SOFTWARE PRACTICES AND TESTING ,Pass,53,18,71,BUSINESS INTELLIGENCE ,Pass,45,19,64,J2EE ,Pass,38,17,55,J2EE AND SOFTWARE TESTING LABORATORY,Pass,71,19,90,PROJECT AND VIVA VOCE ,Pass,213,53,266
M1612214, College : 4306  -  SDVVS S B.C.A. COLLEGE  SANKESHWAR,DISTI,75.24,SOFTWARE PRACTICES AND TESTING ,Pass,61,18,79,BUSINESS INTELLIGENCE ,Pass,46,18,64,J2EE ,Pass,32,17,49,J2EE AND SOFTWARE TESTING LABORATORY,Pass,76,18,94,PROJECT AND VIVA VOCE ,Pass,224,54,278
M1612215, College : 4306  -  SDVVS S B.C.A. COLLEGE  SANKESHWAR,N.C.L,--   ,SOFTWARE PRACTICES AND TESTING ,Pass,57,16,73,BUSINESS INTELLIGENCE ,Pass,55,19,74,J2EE ,Pass,32,18,50,J2EE AND SOFTWARE TESTING LABORATORY,Pass,66,16,82,PROJECT AND VIVA VOCE ,Pass,208,51,259
M1612217, College : 4306  -  SDVVS S B.C.A. COLLEGE  SANKESHWAR,DISTI,71.49,SOFTWARE PRACTICES AND TESTING ,Pass,40,18,58,BUSINESS INTELLIGENCE ,Pass,56,19,75,J2EE ,Pass,39,18,57,J2EE AND SOFTWARE TESTING LABORATORY,Pass,72,19,91,PROJECT AND VIVA VOCE ,Pass,228,56,284
M1612218, College : 4306  -  SDVVS S B.C.A. COLLEGE  SANKESHWAR,DISTI,79.95,SOFTWARE PRACTICES AND TESTING ,Pass,55,17,72,BUSINESS INTELLIGENCE ,Pass,76,18,94,J2EE ,Pass,57,18,75,J2EE AND SOFTWARE TESTING LABORATORY,Pass,73,18,91,PROJECT AND VIVA VOCE ,Pass,222,52,274
M1612221, College : 4306  -  SDVVS S B.C.A. COLLEGE  SANKESHWAR,DISTI,90.3,SOFTWARE PRACTICES AND TESTING ,Pass,73,20,93,BUSINESS INTELLIGENCE ,Pass,79,20,99,J2EE ,Pass,65,20,85,J2EE AND SOFTWARE TESTING LABORATORY,Pass,79,20,99,PROJECT AND VIVA VOCE ,Pass,237,60,297
M1612222, College : 4306  -  SDVVS S B.C.A. COLLEGE  SANKESHWAR,DISTI,90.51,SOFTWARE PRACTICES AND TESTING ,Pass,76,20,96,BUSINESS INTELLIGENCE ,Pass,74,20,94,J2EE ,Pass,71,20,91,J2EE AND SOFTWARE TESTING LABORATORY,Pass,79,20,99,PROJECT AND VIVA VOCE ,Pass,237,60,297
M1612223, College : 4306  -  SDVVS S B.C.A. COLLEGE  SANKESHWAR,DISTI,83.38,SOFTWARE PRACTICES AND TESTING ,Pass,73,15,88,BUSINESS INTELLIGENCE ,Pass,68,19,87,J2EE ,Pass,62,18,80,J2EE AND SOFTWARE TESTING LABORATORY,Pass,76,18,94,PROJECT AND VIVA VOCE ,Pass,236,60,296
M1612224, College : 4306  -  SDVVS S B.C.A. COLLEGE  SANKESHWAR,DISTI,88.59,SOFTWARE PRACTICES AND TESTING ,Pass,73,17,90,BUSINESS INTELLIGENCE ,Pass,65,20,85,J2EE ,Pass,68,20,88,J2EE AND SOFTWARE TESTING LABORATORY,Pass,79,20,99,PROJECT AND VIVA VOCE ,Pass,237,60,297
M1612225, College : 4306  -  SDVVS S B.C.A. COLLEGE  SANKESHWAR,N.C.L,--   ,SOFTWARE PRACTICES AND TESTING ,Pass,40,15,55,BUSINESS INTELLIGENCE ,Pass,60,19,79,J2EE ,Pass,59,16,75,J2EE AND SOFTWARE TESTING LABORATORY,Pass,70,19,89,PROJECT AND VIVA VOCE ,Pass,207,50,257
M1612226, College : 4306  -  SDVVS S B.C.A. COLLEGE  SANKESHWAR,N.C.L,--   ,SOFTWARE PRACTICES AND TESTING ,Pass,39,16,55,BUSINESS INTELLIGENCE ,Pass,47,19,66,J2EE ,Pass,55,18,73,J2EE AND SOFTWARE TESTING LABORATORY,Pass,73,16,89,PROJECT AND VIVA VOCE ,Pass,211,50,261
M1612227, College : 4306  -  SDVVS S B.C.A. COLLEGE  SANKESHWAR,DISTI,73.59,SOFTWARE PRACTICES AND TESTING ,Pass,47,20,67,BUSINESS INTELLIGENCE ,Pass,53,19,72,J2EE ,Pass,57,17,74,J2EE AND SOFTWARE TESTING LABORATORY,Pass,71,18,89,PROJECT AND VIVA VOCE ,Pass,215,51,266
M1612228, College : 4306  -  SDVVS S B.C.A. COLLEGE  SANKESHWAR,DISTI,85.24,SOFTWARE PRACTICES AND TESTING ,Pass,71,19,90,BUSINESS INTELLIGENCE ,Pass,74,19,93,J2EE ,Pass,58,19,77,J2EE AND SOFTWARE TESTING LABORATORY,Pass,78,20,98,PROJECT AND VIVA VOCE ,Pass,234,58,292
M1612229, College : 4306  -  SDVVS S B.C.A. COLLEGE  SANKESHWAR,DISTI,71.49,SOFTWARE PRACTICES AND TESTING ,Pass,64,18,82,BUSINESS INTELLIGENCE ,Pass,55,19,74,J2EE ,Pass,55,19,74,J2EE AND SOFTWARE TESTING LABORATORY,Pass,72,18,90,PROJECT AND VIVA VOCE ,Pass,214,53,267
M1612230, College : 4306  -  SDVVS S B.C.A. COLLEGE  SANKESHWAR,DISTI,78.97,SOFTWARE PRACTICES AND TESTING ,Pass,61,19,80,BUSINESS INTELLIGENCE ,Pass,68,19,87,J2EE ,Pass,52,20,72,J2EE AND SOFTWARE TESTING LABORATORY,Pass,76,20,96,PROJECT AND VIVA VOCE ,Pass,230,57,287
M1612231, College : 4306  -  SDVVS S B.C.A. COLLEGE  SANKESHWAR,DISTI,78.92,SOFTWARE PRACTICES AND TESTING ,Pass,60,19,79,BUSINESS INTELLIGENCE ,Pass,66,18,84,J2EE ,Pass,54,19,73,J2EE AND SOFTWARE TESTING LABORATORY,Pass,74,18,92,PROJECT AND VIVA VOCE ,Pass,227,56,283
M1612232, College : 4306  -  SDVVS S B.C.A. COLLEGE  SANKESHWAR,DISTI,75.57,SOFTWARE PRACTICES AND TESTING ,Pass,55,20,75,BUSINESS INTELLIGENCE ,Pass,67,19,86,J2EE ,Pass,43,19,62,J2EE AND SOFTWARE TESTING LABORATORY,Pass,71,17,88,PROJECT AND VIVA VOCE ,Pass,218,52,270
M1612233, College : 4306  -  SDVVS S B.C.A. COLLEGE  SANKESHWAR,DISTI,84.03,SOFTWARE PRACTICES AND TESTING ,Pass,70,19,89,BUSINESS INTELLIGENCE ,Pass,70,19,89,J2EE ,Pass,56,19,75,J2EE AND SOFTWARE TESTING LABORATORY,Pass,77,20,97,PROJECT AND VIVA VOCE ,Pass,232,56,288
M1612234, College : 4306  -  SDVVS S B.C.A. COLLEGE  SANKESHWAR,N.C.L,--   ,SOFTWARE PRACTICES AND TESTING ,Pass,55,12,67,BUSINESS INTELLIGENCE ,Pass,54,19,73,J2EE ,Pass,54,11,65,J2EE AND SOFTWARE TESTING LABORATORY,Pass,67,16,83,PROJECT AND VIVA VOCE ,Pass,205,50,255
M1612235, College : 4306  -  SDVVS S B.C.A. COLLEGE  SANKESHWAR,FAIL,66.43,SOFTWARE PRACTICES AND TESTING ,Fail,15,13,28,BUSINESS INTELLIGENCE ,Pass,35,19,54,J2EE ,Pass,32,16,48,J2EE AND SOFTWARE TESTING LABORATORY,Pass,63,16,79,PROJECT AND VIVA VOCE ,Pass,205,51,256
M1612237, College : 4306  -  SDVVS S B.C.A. COLLEGE  SANKESHWAR,N.C.L,--   ,SOFTWARE PRACTICES AND TESTING ,Pass,43,14,57,BUSINESS INTELLIGENCE ,Pass,45,19,64,J2EE ,Pass,32,16,48,J2EE AND SOFTWARE TESTING LABORATORY,Pass,76,19,95,PROJECT AND VIVA VOCE ,Pass,235,56,291
M1612238, College : 4306  -  SDVVS S B.C.A. COLLEGE  SANKESHWAR,N.C.L,--   ,SOFTWARE PRACTICES AND TESTING ,Pass,40,13,53,BUSINESS INTELLIGENCE ,Pass,39,19,58,J2EE ,Pass,41,17,58,J2EE AND SOFTWARE TESTING LABORATORY,Pass,65,16,81,PROJECT AND VIVA VOCE ,Pass,212,50,262
M1612239, College : 4306  -  SDVVS S B.C.A. COLLEGE  SANKESHWAR,N.C.L,--   ,SOFTWARE PRACTICES AND TESTING ,Pass,52,18,70,BUSINESS INTELLIGENCE ,Pass,59,19,78,J2EE ,Pass,45,19,64,J2EE AND SOFTWARE TESTING LABORATORY,Pass,78,20,98,PROJECT AND VIVA VOCE ,Pass,230,55,285
M1612240, College : 4306  -  SDVVS S B.C.A. COLLEGE  SANKESHWAR,DISTI,77.81,SOFTWARE PRACTICES AND TESTING ,Pass,52,15,67,BUSINESS INTELLIGENCE ,Pass,52,18,70,J2EE ,Pass,44,18,62,J2EE AND SOFTWARE TESTING LABORATORY,Pass,76,18,94,PROJECT AND VIVA VOCE ,Pass,235,57,292
M1612241, College : 4306  -  SDVVS S B.C.A. COLLEGE  SANKESHWAR,N.C.L,--   ,SOFTWARE PRACTICES AND TESTING ,Pass,45,12,57,BUSINESS INTELLIGENCE ,Pass,56,18,74,J2EE ,Pass,36,13,49,J2EE AND SOFTWARE TESTING LABORATORY,Pass,69,16,85,PROJECT AND VIVA VOCE ,Pass,210,51,261
M1612246, College : 4306  -  SDVVS S B.C.A. COLLEGE  SANKESHWAR,N.C.L,--   ,SOFTWARE PRACTICES AND TESTING ,Pass,38,16,54,BUSINESS INTELLIGENCE ,Pass,56,19,75,J2EE ,Pass,44,16,60,J2EE AND SOFTWARE TESTING LABORATORY,Pass,67,17,84,PROJECT AND VIVA VOCE ,Pass,208,52,260
M1612247, College : 4306  -  SDVVS S B.C.A. COLLEGE  SANKESHWAR,N.C.L,--   ,SOFTWARE PRACTICES AND TESTING ,Pass,35,13,48,BUSINESS INTELLIGENCE ,Pass,55,19,74,J2EE ,Pass,36,12,48,J2EE AND SOFTWARE TESTING LABORATORY,Pass,69,17,86,PROJECT AND VIVA VOCE ,Pass,209,50,259
M1612248, College : 4306  -  SDVVS S B.C.A. COLLEGE  SANKESHWAR,N.C.L,--   ,SOFTWARE PRACTICES AND TESTING ,Pass,42,18,60,BUSINESS INTELLIGENCE ,Pass,62,19,81,J2EE ,Pass,40,20,60,J2EE AND SOFTWARE TESTING LABORATORY,Pass,75,20,95,PROJECT AND VIVA VOCE ,Pass,226,56,282
M1612249, College : 4306  -  SDVVS S B.C.A. COLLEGE  SANKESHWAR,DISTI,94.51,SOFTWARE PRACTICES AND TESTING ,Pass,78,20,98,BUSINESS INTELLIGENCE ,Pass,78,20,98,J2EE ,Pass,70,20,90,J2EE AND SOFTWARE TESTING LABORATORY,Pass,80,20,100,PROJECT AND VIVA VOCE ,Pass,238,60,298
M1612251, College : 4306  -  SDVVS S B.C.A. COLLEGE  SANKESHWAR,DISTI,79.51,SOFTWARE PRACTICES AND TESTING ,Pass,55,15,70,BUSINESS INTELLIGENCE ,Pass,64,19,83,J2EE ,Pass,47,18,65,J2EE AND SOFTWARE TESTING LABORATORY,Pass,74,19,93,PROJECT AND VIVA VOCE ,Pass,225,55,280
M1612252, College : 4306  -  SDVVS S B.C.A. COLLEGE  SANKESHWAR,DISTI,77.14,SOFTWARE PRACTICES AND TESTING ,Pass,46,16,62,BUSINESS INTELLIGENCE ,Pass,53,18,71,J2EE ,Pass,43,18,61,J2EE AND SOFTWARE TESTING LABORATORY,Pass,75,20,95,PROJECT AND VIVA VOCE ,Pass,228,54,282
M1612253, College : 4306  -  SDVVS S B.C.A. COLLEGE  SANKESHWAR,N.C.L,--   ,SOFTWARE PRACTICES AND TESTING ,Pass,32,13,45,BUSINESS INTELLIGENCE ,Pass,32,19,51,J2EE ,Pass,32,13,45,J2EE AND SOFTWARE TESTING LABORATORY,Pass,69,18,87,PROJECT AND VIVA VOCE ,Pass,207,51,258
M1612402, College : 4314  -  P E S S BCA COLLEGE  BELAGAVI,DISTI,71.24,SOFTWARE PRACTICES AND TESTING ,Pass,43,8,51,BUSINESS INTELLIGENCE ,Pass,46,10,56,J2EE ,Pass,35,11,46,J2EE AND SOFTWARE TESTING LABORATORY,Pass,53,10,63,PROJECT AND VIVA VOCE ,Pass,216,43,259
M1612403, College : 4314  -  P E S S BCA COLLEGE  BELAGAVI,DISTI,78.43,SOFTWARE PRACTICES AND TESTING ,Pass,54,13,67,BUSINESS INTELLIGENCE ,Pass,52,17,69,J2EE ,Pass,38,14,52,J2EE AND SOFTWARE TESTING LABORATORY,Pass,77,18,95,PROJECT AND VIVA VOCE ,Pass,180,40,220
M1612405, College : 4314  -  P E S S BCA COLLEGE  BELAGAVI,1ST C,63.3,SOFTWARE PRACTICES AND TESTING ,Pass,40,8,48,BUSINESS INTELLIGENCE ,Pass,46,12,58,J2EE ,Pass,41,13,54,J2EE AND SOFTWARE TESTING LABORATORY,Pass,72,15,87,PROJECT AND VIVA VOCE ,Pass,150,41,191
M1612406, College : 4314  -  P E S S BCA COLLEGE  BELAGAVI,DISTI,71.11,SOFTWARE PRACTICES AND TESTING ,Pass,48,9,57,BUSINESS INTELLIGENCE ,Pass,52,18,70,J2EE ,Pass,44,16,60,J2EE AND SOFTWARE TESTING LABORATORY,Pass,73,17,90,PROJECT AND VIVA VOCE ,Pass,135,45,180
M1612408, College : 4314  -  P E S S BCA COLLEGE  BELAGAVI,DISTI,71.7,SOFTWARE PRACTICES AND TESTING ,Pass,56,8,64,BUSINESS INTELLIGENCE ,Pass,60,9,69,J2EE ,Pass,48,10,58,J2EE AND SOFTWARE TESTING LABORATORY,Pass,76,8,84,PROJECT AND VIVA VOCE ,Pass,215,40,255
M1612409, College : 4314  -  P E S S BCA COLLEGE  BELAGAVI,1ST C,61.65,SOFTWARE PRACTICES AND TESTING ,Pass,52,8,60,BUSINESS INTELLIGENCE ,Pass,57,9,66,J2EE ,Pass,50,11,61,J2EE AND SOFTWARE TESTING LABORATORY,Pass,73,15,88,PROJECT AND VIVA VOCE ,Pass,180,42,222
M1612410, College : 4314  -  P E S S BCA COLLEGE  BELAGAVI,DISTI,73.51,SOFTWARE PRACTICES AND TESTING ,Pass,56,10,66,BUSINESS INTELLIGENCE ,Pass,56,18,74,J2EE ,Pass,42,14,56,J2EE AND SOFTWARE TESTING LABORATORY,Pass,74,16,90,PROJECT AND VIVA VOCE ,Pass,196,43,239
M1612411, College : 4314  -  P E S S BCA COLLEGE  BELAGAVI,N.C.L,--   ,SOFTWARE PRACTICES AND TESTING ,Pass,45,11,56,BUSINESS INTELLIGENCE ,Pass,54,11,65,J2EE ,Pass,42,13,55,J2EE AND SOFTWARE TESTING LABORATORY,Pass,76,17,93,PROJECT AND VIVA VOCE ,Pass,195,41,236
M1612412, College : 4314  -  P E S S BCA COLLEGE  BELAGAVI,N.C.L,--   ,SOFTWARE PRACTICES AND TESTING ,Pass,54,9,63,BUSINESS INTELLIGENCE ,Pass,62,9,71,J2EE ,Pass,46,10,56,J2EE AND SOFTWARE TESTING LABORATORY,Pass,74,13,87,PROJECT AND VIVA VOCE ,Pass,200,40,240
M1612413, College : 4314  -  P E S S BCA COLLEGE  BELAGAVI,N.C.L,--   ,SOFTWARE PRACTICES AND TESTING ,Pass,44,8,52,BUSINESS INTELLIGENCE ,Pass,56,8,64,J2EE ,Pass,47,9,56,J2EE AND SOFTWARE TESTING LABORATORY,Pass,75,15,90,PROJECT AND VIVA VOCE ,Pass,200,42,242
M1612414, College : 4314  -  P E S S BCA COLLEGE  BELAGAVI,N.C.L,--   ,SOFTWARE PRACTICES AND TESTING ,Pass,32,8,40,BUSINESS INTELLIGENCE ,Pass,44,9,53,J2EE ,Pass,43,10,53,J2EE AND SOFTWARE TESTING LABORATORY,Pass,32,8,40,PROJECT AND VIVA VOCE ,Pass,125,35,160
M1612416, College : 4314  -  P E S S BCA COLLEGE  BELAGAVI,DISTI,73.19,SOFTWARE PRACTICES AND TESTING ,Pass,58,12,70,BUSINESS INTELLIGENCE ,Pass,51,16,67,J2EE ,Pass,51,14,65,J2EE AND SOFTWARE TESTING LABORATORY,Pass,51,17,68,PROJECT AND VIVA VOCE ,Pass,145,40,185
M1612417, College : 4314  -  P E S S BCA COLLEGE  BELAGAVI,N.C.L,--   ,SOFTWARE PRACTICES AND TESTING ,Pass,43,8,51,BUSINESS INTELLIGENCE ,Pass,48,10,58,J2EE ,Pass,46,10,56,J2EE AND SOFTWARE TESTING LABORATORY,Pass,73,14,87,PROJECT AND VIVA VOCE ,Pass,200,50,250
M1612418, College : 4314  -  P E S S BCA COLLEGE  BELAGAVI,DISTI,73,SOFTWARE PRACTICES AND TESTING ,Pass,35,13,48,BUSINESS INTELLIGENCE ,Pass,42,16,58,J2EE ,Pass,39,15,54,J2EE AND SOFTWARE TESTING LABORATORY,Pass,74,15,89,PROJECT AND VIVA VOCE ,Pass,190,48,238
M1612419, College : 4314  -  P E S S BCA COLLEGE  BELAGAVI,N.C.L,--   ,SOFTWARE PRACTICES AND TESTING ,Pass,33,8,41,BUSINESS INTELLIGENCE ,Pass,47,8,55,J2EE ,Pass,43,12,55,J2EE AND SOFTWARE TESTING LABORATORY,Pass,72,15,87,PROJECT AND VIVA VOCE ,Pass,195,50,245
M1612420, College : 4314  -  P E S S BCA COLLEGE  BELAGAVI,N.C.L,--   ,SOFTWARE PRACTICES AND TESTING ,Pass,40,9,49,BUSINESS INTELLIGENCE ,Pass,51,14,65,J2EE ,Pass,46,9,55,J2EE AND SOFTWARE TESTING LABORATORY,Pass,76,8,84,PROJECT AND VIVA VOCE ,Pass,215,51,266
M1612421, College : 4314  -  P E S S BCA COLLEGE  BELAGAVI,1ST C,66.92,SOFTWARE PRACTICES AND TESTING ,Pass,47,9,56,BUSINESS INTELLIGENCE ,Pass,54,10,64,J2EE ,Pass,44,11,55,J2EE AND SOFTWARE TESTING LABORATORY,Pass,63,14,77,PROJECT AND VIVA VOCE ,Pass,150,41,191
M1612422, College : 4314  -  P E S S BCA COLLEGE  BELAGAVI,DISTI,84.11,SOFTWARE PRACTICES AND TESTING ,Pass,64,16,80,BUSINESS INTELLIGENCE ,Pass,64,16,80,J2EE ,Pass,47,15,62,J2EE AND SOFTWARE TESTING LABORATORY,Pass,75,16,91,PROJECT AND VIVA VOCE ,Pass,200,42,242
M1612423, College : 4314  -  P E S S BCA COLLEGE  BELAGAVI,N.C.L,--   ,SOFTWARE PRACTICES AND TESTING ,Pass,34,8,42,BUSINESS INTELLIGENCE ,Pass,51,11,62,J2EE ,Pass,32,11,43,J2EE AND SOFTWARE TESTING LABORATORY,Pass,71,15,86,PROJECT AND VIVA VOCE ,Pass,215,40,255
M1612425, College : 4314  -  P E S S BCA COLLEGE  BELAGAVI,N.C.L,--   ,SOFTWARE PRACTICES AND TESTING ,Pass,42,8,50,BUSINESS INTELLIGENCE ,Pass,46,8,54,J2EE ,Pass,33,11,44,J2EE AND SOFTWARE TESTING LABORATORY,Pass,69,12,81,PROJECT AND VIVA VOCE ,Pass,175,45,220
M1612426, College : 4314  -  P E S S BCA COLLEGE  BELAGAVI,DISTI,77.14,SOFTWARE PRACTICES AND TESTING ,Pass,58,13,71,BUSINESS INTELLIGENCE ,Pass,55,10,65,J2EE ,Pass,37,13,50,J2EE AND SOFTWARE TESTING LABORATORY,Pass,71,17,88,PROJECT AND VIVA VOCE ,Pass,200,45,245
M1612427, College : 4314  -  P E S S BCA COLLEGE  BELAGAVI,N.C.L,--   ,SOFTWARE PRACTICES AND TESTING ,Pass,42,9,51,BUSINESS INTELLIGENCE ,Pass,45,14,59,J2EE ,Pass,34,14,48,J2EE AND SOFTWARE TESTING LABORATORY,Pass,71,11,82,PROJECT AND VIVA VOCE ,Pass,150,35,185
M1612428, College : 4314  -  P E S S BCA COLLEGE  BELAGAVI,DISTI,73.81,SOFTWARE PRACTICES AND TESTING ,Pass,46,8,54,BUSINESS INTELLIGENCE ,Pass,49,8,57,J2EE ,Pass,35,12,47,J2EE AND SOFTWARE TESTING LABORATORY,Pass,75,16,91,PROJECT AND VIVA VOCE ,Pass,205,42,247
M1612431, College : 4314  -  P E S S BCA COLLEGE  BELAGAVI,DISTI,79.16,SOFTWARE PRACTICES AND TESTING ,Pass,54,15,69,BUSINESS INTELLIGENCE ,Pass,52,20,72,J2EE ,Pass,40,13,53,J2EE AND SOFTWARE TESTING LABORATORY,Pass,74,17,91,PROJECT AND VIVA VOCE ,Pass,150,40,190
M1612432, College : 4314  -  P E S S BCA COLLEGE  BELAGAVI,N.C.L,--   ,SOFTWARE PRACTICES AND TESTING ,Pass,41,8,49,BUSINESS INTELLIGENCE ,Pass,50,8,58,J2EE ,Pass,36,8,44,J2EE AND SOFTWARE TESTING LABORATORY,Pass,71,14,85,PROJECT AND VIVA VOCE ,Pass,146,40,186
M1612433, College : 4314  -  P E S S BCA COLLEGE  BELAGAVI,DISTI,72.92,SOFTWARE PRACTICES AND TESTING ,Pass,60,8,68,BUSINESS INTELLIGENCE ,Pass,44,10,54,J2EE ,Pass,44,12,56,J2EE AND SOFTWARE TESTING LABORATORY,Pass,78,17,95,PROJECT AND VIVA VOCE ,Pass,165,42,207
M1612434, College : 4314  -  P E S S BCA COLLEGE  BELAGAVI,DISTI,75.73,SOFTWARE PRACTICES AND TESTING ,Pass,55,16,71,BUSINESS INTELLIGENCE ,Pass,51,20,71,J2EE ,Pass,47,13,60,J2EE AND SOFTWARE TESTING LABORATORY,Pass,75,17,92,PROJECT AND VIVA VOCE ,Pass,210,51,261
M1612435, College : 4314  -  P E S S BCA COLLEGE  BELAGAVI,FAIL,56.57,SOFTWARE PRACTICES AND TESTING ,Fail,19,9,28,BUSINESS INTELLIGENCE ,Pass,41,8,49,J2EE ,Fail,16,10,26,J2EE AND SOFTWARE TESTING LABORATORY,Pass,72,8,80,PROJECT AND VIVA VOCE ,Pass,175,38,213
M1612601, College : 4315  -  S S E SOCIETY S SWAMI VIVEKANAND  B.C.A. COLLEGE  HAROGERI,FAIL,71.86,SOFTWARE PRACTICES AND TESTING ,Pass,43,17,60,BUSINESS INTELLIGENCE ,Pass,49,16,65,J2EE ,Fail,21,17,38,J2EE AND SOFTWARE TESTING LABORATORY,Pass,68,17,85,PROJECT AND VIVA VOCE ,Pass,205,50,255
M1612602, College : 4315  -  S S E SOCIETY S SWAMI VIVEKANAND  B.C.A. COLLEGE  HAROGERI,DISTI,78.35,SOFTWARE PRACTICES AND TESTING ,Pass,38,19,57,BUSINESS INTELLIGENCE ,Pass,57,19,76,J2EE ,Pass,55,19,74,J2EE AND SOFTWARE TESTING LABORATORY,Pass,78,19,97,PROJECT AND VIVA VOCE ,Pass,235,58,293
M1612604, College : 4315  -  S S E SOCIETY S SWAMI VIVEKANAND  B.C.A. COLLEGE  HAROGERI,DISTI,76.14,SOFTWARE PRACTICES AND TESTING ,Pass,33,18,51,BUSINESS INTELLIGENCE ,Pass,67,18,85,J2EE ,Pass,54,16,70,J2EE AND SOFTWARE TESTING LABORATORY,Pass,75,16,91,PROJECT AND VIVA VOCE ,Pass,230,56,286
M1612605, College : 4315  -  S S E SOCIETY S SWAMI VIVEKANAND  B.C.A. COLLEGE  HAROGERI,N.C.L,--   ,SOFTWARE PRACTICES AND TESTING ,Pass,43,17,60,BUSINESS INTELLIGENCE ,Pass,52,17,69,J2EE ,Pass,32,18,50,J2EE AND SOFTWARE TESTING LABORATORY,Pass,70,18,88,PROJECT AND VIVA VOCE ,Pass,210,52,262
M1612606, College : 4315  -  S S E SOCIETY S SWAMI VIVEKANAND  B.C.A. COLLEGE  HAROGERI,N.C.L,--   ,SOFTWARE PRACTICES AND TESTING ,Pass,43,17,60,BUSINESS INTELLIGENCE ,Pass,52,16,68,J2EE ,Pass,32,17,49,J2EE AND SOFTWARE TESTING LABORATORY,Pass,69,17,86,PROJECT AND VIVA VOCE ,Pass,200,50,250
M1612607, College : 4315  -  S S E SOCIETY S SWAMI VIVEKANAND  B.C.A. COLLEGE  HAROGERI,N.C.L,--   ,SOFTWARE PRACTICES AND TESTING ,Pass,32,16,48,BUSINESS INTELLIGENCE ,Pass,58,16,74,J2EE ,Pass,52,16,68,J2EE AND SOFTWARE TESTING LABORATORY,Pass,74,16,90,PROJECT AND VIVA VOCE ,Pass,230,57,287
M1612608, College : 4315  -  S S E SOCIETY S SWAMI VIVEKANAND  B.C.A. COLLEGE  HAROGERI,DISTI,79.78,SOFTWARE PRACTICES AND TESTING ,Pass,48,18,66,BUSINESS INTELLIGENCE ,Pass,67,18,85,J2EE ,Pass,66,19,85,J2EE AND SOFTWARE TESTING LABORATORY,Pass,78,19,97,PROJECT AND VIVA VOCE ,Pass,234,58,292
M1612609, College : 4315  -  S S E SOCIETY S SWAMI VIVEKANAND  B.C.A. COLLEGE  HAROGERI,N.C.L,--   ,SOFTWARE PRACTICES AND TESTING ,Pass,46,17,63,BUSINESS INTELLIGENCE ,Pass,52,17,69,J2EE ,Pass,40,18,58,J2EE AND SOFTWARE TESTING LABORATORY,Pass,70,18,88,PROJECT AND VIVA VOCE ,Pass,215,52,267
M1612610, College : 4315  -  S S E SOCIETY S SWAMI VIVEKANAND  B.C.A. COLLEGE  HAROGERI,N.C.L,--   ,SOFTWARE PRACTICES AND TESTING ,Pass,45,18,63,BUSINESS INTELLIGENCE ,Pass,53,18,71,J2EE ,Pass,36,18,54,J2EE AND SOFTWARE TESTING LABORATORY,Pass,71,18,89,PROJECT AND VIVA VOCE ,Pass,218,54,272
M1612612, College : 4315  -  S S E SOCIETY S SWAMI VIVEKANAND  B.C.A. COLLEGE  HAROGERI,N.C.L,--   ,SOFTWARE PRACTICES AND TESTING ,Pass,44,17,61,BUSINESS INTELLIGENCE ,Pass,49,16,65,J2EE ,Pass,37,16,53,J2EE AND SOFTWARE TESTING LABORATORY,Pass,65,17,82,PROJECT AND VIVA VOCE ,Pass,180,50,230
M1612613, College : 4315  -  S S E SOCIETY S SWAMI VIVEKANAND  B.C.A. COLLEGE  HAROGERI,N.C.L,--   ,SOFTWARE PRACTICES AND TESTING ,Pass,32,18,50,BUSINESS INTELLIGENCE ,Pass,50,18,68,J2EE ,Pass,32,18,50,J2EE AND SOFTWARE TESTING LABORATORY,Pass,71,18,89,PROJECT AND VIVA VOCE ,Pass,210,55,265
M1612614, College : 4315  -  S S E SOCIETY S SWAMI VIVEKANAND  B.C.A. COLLEGE  HAROGERI,N.C.L,--   ,SOFTWARE PRACTICES AND TESTING ,Pass,32,18,50,BUSINESS INTELLIGENCE ,Pass,51,18,69,J2EE ,Pass,37,18,55,J2EE AND SOFTWARE TESTING LABORATORY,Pass,72,19,91,PROJECT AND VIVA VOCE ,Pass,215,55,270
M1612801, College : 4316  -  SWAMI VIVEKANAND B.C.A. COLLEGE  NANADI,N.C.L,--   ,SOFTWARE PRACTICES AND TESTING ,Pass,46,10,56,BUSINESS INTELLIGENCE ,Pass,49,14,63,J2EE ,Pass,33,12,45,J2EE AND SOFTWARE TESTING LABORATORY,Pass,57,14,71,PROJECT AND VIVA VOCE ,Pass,210,43,253
M1612802, College : 4316  -  SWAMI VIVEKANAND B.C.A. COLLEGE  NANADI,DISTI,80.38,SOFTWARE PRACTICES AND TESTING ,Pass,51,15,66,BUSINESS INTELLIGENCE ,Pass,64,16,80,J2EE ,Pass,34,13,47,J2EE AND SOFTWARE TESTING LABORATORY,Pass,63,11,74,PROJECT AND VIVA VOCE ,Pass,225,56,281
M1612803, College : 4316  -  SWAMI VIVEKANAND B.C.A. COLLEGE  NANADI,FAIL,40.57,SOFTWARE PRACTICES AND TESTING ,Fail,15,8,23,BUSINESS INTELLIGENCE ,Fail,4,8,12,J2EE ,Pass,32,8,40,J2EE AND SOFTWARE TESTING LABORATORY,Pass,50,9,59,PROJECT AND VIVA VOCE ,Pass,120,30,150
M1612804, College : 4316  -  SWAMI VIVEKANAND B.C.A. COLLEGE  NANADI,DISTI,76.41,SOFTWARE PRACTICES AND TESTING ,Pass,51,18,69,BUSINESS INTELLIGENCE ,Pass,67,17,84,J2EE ,Pass,57,15,72,J2EE AND SOFTWARE TESTING LABORATORY,Pass,74,18,92,PROJECT AND VIVA VOCE ,Pass,195,56,251
M1612806, College : 4316  -  SWAMI VIVEKANAND B.C.A. COLLEGE  NANADI,FAIL,55.29,SOFTWARE PRACTICES AND TESTING ,Pass,32,8,40,BUSINESS INTELLIGENCE ,Fail,11,8,19,J2EE ,Fail,9,8,17,J2EE AND SOFTWARE TESTING LABORATORY,Pass,48,8,56,PROJECT AND VIVA VOCE ,Pass,205,50,255
M1612807, College : 4316  -  SWAMI VIVEKANAND B.C.A. COLLEGE  NANADI,DISTI,79.16,SOFTWARE PRACTICES AND TESTING ,Pass,62,18,80,BUSINESS INTELLIGENCE ,Pass,70,19,89,J2EE ,Pass,51,18,69,J2EE AND SOFTWARE TESTING LABORATORY,Pass,73,19,92,PROJECT AND VIVA VOCE ,Pass,220,57,277
M1612810, College : 4316  -  SWAMI VIVEKANAND B.C.A. COLLEGE  NANADI,1ST C,64.16,SOFTWARE PRACTICES AND TESTING ,Pass,34,12,46,BUSINESS INTELLIGENCE ,Pass,60,14,74,J2EE ,Pass,34,12,46,J2EE AND SOFTWARE TESTING LABORATORY,Pass,63,16,79,PROJECT AND VIVA VOCE ,Pass,210,57,267
M1612811, College : 4316  -  SWAMI VIVEKANAND B.C.A. COLLEGE  NANADI,1ST C,63.22,SOFTWARE PRACTICES AND TESTING ,Pass,40,14,54,BUSINESS INTELLIGENCE ,Pass,55,16,71,J2EE ,Pass,38,16,54,J2EE AND SOFTWARE TESTING LABORATORY,Pass,56,16,72,PROJECT AND VIVA VOCE ,Pass,200,50,250
M1612813, College : 4316  -  SWAMI VIVEKANAND B.C.A. COLLEGE  NANADI,FAIL,54.57,SOFTWARE PRACTICES AND TESTING ,Pass,33,16,49,BUSINESS INTELLIGENCE ,Pass,33,15,48,J2EE ,Fail,20,15,35,J2EE AND SOFTWARE TESTING LABORATORY,Fail,Ab.,15,15,PROJECT AND VIVA VOCE ,Pass,190,45,235
M1612814, College : 4316  -  SWAMI VIVEKANAND B.C.A. COLLEGE  NANADI,DISTI,74.81,SOFTWARE PRACTICES AND TESTING ,Pass,42,18,60,BUSINESS INTELLIGENCE ,Pass,57,19,76,J2EE ,Pass,47,17,64,J2EE AND SOFTWARE TESTING LABORATORY,Pass,74,20,94,PROJECT AND VIVA VOCE ,Pass,220,57,277
M1612815, College : 4316  -  SWAMI VIVEKANAND B.C.A. COLLEGE  NANADI,FAIL,65.71,SOFTWARE PRACTICES AND TESTING ,Pass,35,11,46,BUSINESS INTELLIGENCE ,Pass,46,14,60,J2EE ,Fail,19,12,31,J2EE AND SOFTWARE TESTING LABORATORY,Pass,70,16,86,PROJECT AND VIVA VOCE ,Pass,185,52,237
M1612817, College : 4316  -  SWAMI VIVEKANAND B.C.A. COLLEGE  NANADI,FAIL,64.86,SOFTWARE PRACTICES AND TESTING ,Pass,32,9,41,BUSINESS INTELLIGENCE ,Pass,32,13,45,J2EE ,Fail,19,12,31,J2EE AND SOFTWARE TESTING LABORATORY,Pass,72,15,87,PROJECT AND VIVA VOCE ,Pass,200,50,250
M1612818, College : 4316  -  SWAMI VIVEKANAND B.C.A. COLLEGE  NANADI,FAIL,47.14,SOFTWARE PRACTICES AND TESTING ,Fail,21,9,30,BUSINESS INTELLIGENCE ,Fail,7,10,17,J2EE ,Fail,12,9,21,J2EE AND SOFTWARE TESTING LABORATORY,Pass,36,15,51,PROJECT AND VIVA VOCE ,Pass,170,41,211
M1612819, College : 4316  -  SWAMI VIVEKANAND B.C.A. COLLEGE  NANADI,1ST C,65.43,SOFTWARE PRACTICES AND TESTING ,Pass,32,15,47,BUSINESS INTELLIGENCE ,Pass,32,14,46,J2EE ,Pass,32,13,45,J2EE AND SOFTWARE TESTING LABORATORY,Pass,71,18,89,PROJECT AND VIVA VOCE ,Pass,210,57,267
M1612820, College : 4316  -  SWAMI VIVEKANAND B.C.A. COLLEGE  NANADI,N.C.L,--   ,SOFTWARE PRACTICES AND TESTING ,Pass,37,11,48,BUSINESS INTELLIGENCE ,Pass,32,12,44,J2EE ,Pass,32,13,45,J2EE AND SOFTWARE TESTING LABORATORY,Pass,41,12,53,PROJECT AND VIVA VOCE ,Pass,195,50,245
M1612821, College : 4316  -  SWAMI VIVEKANAND B.C.A. COLLEGE  NANADI,N.C.L,--   ,SOFTWARE PRACTICES AND TESTING ,Pass,42,15,57,BUSINESS INTELLIGENCE ,Pass,32,17,49,J2EE ,Pass,38,14,52,J2EE AND SOFTWARE TESTING LABORATORY,Pass,54,13,67,PROJECT AND VIVA VOCE ,Pass,185,52,237
M1612822, College : 4316  -  SWAMI VIVEKANAND B.C.A. COLLEGE  NANADI,FAIL,66.86,SOFTWARE PRACTICES AND TESTING ,Pass,41,17,58,BUSINESS INTELLIGENCE ,Pass,32,17,49,J2EE ,Fail,20,15,35,J2EE AND SOFTWARE TESTING LABORATORY,Pass,72,19,91,PROJECT AND VIVA VOCE ,Pass,180,55,235
M1612823, College : 4316  -  SWAMI VIVEKANAND B.C.A. COLLEGE  NANADI,DISTI,72.41,SOFTWARE PRACTICES AND TESTING ,Pass,50,17,67,BUSINESS INTELLIGENCE ,Pass,38,19,57,J2EE ,Pass,64,16,80,J2EE AND SOFTWARE TESTING LABORATORY,Pass,78,19,97,PROJECT AND VIVA VOCE ,Pass,215,56,271
M1612824, College : 4316  -  SWAMI VIVEKANAND B.C.A. COLLEGE  NANADI,DISTI,72.73,SOFTWARE PRACTICES AND TESTING ,Pass,37,17,54,BUSINESS INTELLIGENCE ,Pass,56,18,74,J2EE ,Pass,51,15,66,J2EE AND SOFTWARE TESTING LABORATORY,Pass,74,19,93,PROJECT AND VIVA VOCE ,Pass,205,54,259
M1613001, College : 4361  -  D M S M COLLEGE OF COMPUTER APPLICATION  BELAGAVI,DISTI,84.89,SOFTWARE PRACTICES AND TESTING ,Pass,51,20,71,BUSINESS INTELLIGENCE ,Pass,70,20,90,J2EE ,Pass,69,20,89,J2EE AND SOFTWARE TESTING LABORATORY,Pass,80,20,100,PROJECT AND VIVA VOCE ,Pass,237,60,297
M1613002, College : 4361  -  D M S M COLLEGE OF COMPUTER APPLICATION  BELAGAVI,DISTI,80.68,SOFTWARE PRACTICES AND TESTING ,Pass,42,19,61,BUSINESS INTELLIGENCE ,Pass,65,19,84,J2EE ,Pass,60,19,79,J2EE AND SOFTWARE TESTING LABORATORY,Pass,78,19,97,PROJECT AND VIVA VOCE ,Pass,235,58,293
M1613003, College : 4361  -  D M S M COLLEGE OF COMPUTER APPLICATION  BELAGAVI,DISTI,73,SOFTWARE PRACTICES AND TESTING ,Pass,39,19,58,BUSINESS INTELLIGENCE ,Pass,55,19,74,J2EE ,Pass,48,19,67,J2EE AND SOFTWARE TESTING LABORATORY,Pass,78,19,97,PROJECT AND VIVA VOCE ,Pass,235,58,293
M1613005, College : 4361  -  D M S M COLLEGE OF COMPUTER APPLICATION  BELAGAVI,DISTI,82.08,SOFTWARE PRACTICES AND TESTING ,Pass,41,20,61,BUSINESS INTELLIGENCE ,Pass,64,20,84,J2EE ,Pass,67,20,87,J2EE AND SOFTWARE TESTING LABORATORY,Pass,80,20,100,PROJECT AND VIVA VOCE ,Pass,236,59,295
M1613006, College : 4361  -  D M S M COLLEGE OF COMPUTER APPLICATION  BELAGAVI,DISTI,91.84,SOFTWARE PRACTICES AND TESTING ,Pass,73,20,93,BUSINESS INTELLIGENCE ,Pass,79,20,99,J2EE ,Pass,75,20,95,J2EE AND SOFTWARE TESTING LABORATORY,Pass,80,20,100,PROJECT AND VIVA VOCE ,Pass,238,60,298
M1613007, College : 4361  -  D M S M COLLEGE OF COMPUTER APPLICATION  BELAGAVI,DISTI,82.57,SOFTWARE PRACTICES AND TESTING ,Pass,74,20,94,BUSINESS INTELLIGENCE ,Pass,77,20,97,J2EE ,Pass,52,20,72,J2EE AND SOFTWARE TESTING LABORATORY,Pass,79,20,99,PROJECT AND VIVA VOCE ,Pass,235,58,293
M1613008, College : 4361  -  D M S M COLLEGE OF COMPUTER APPLICATION  BELAGAVI,DISTI,77.49,SOFTWARE PRACTICES AND TESTING ,Pass,32,18,50,BUSINESS INTELLIGENCE ,Pass,58,18,76,J2EE ,Pass,48,18,66,J2EE AND SOFTWARE TESTING LABORATORY,Pass,77,18,95,PROJECT AND VIVA VOCE ,Pass,234,58,292
M1613010, College : 4361  -  D M S M COLLEGE OF COMPUTER APPLICATION  BELAGAVI,DISTI,73.57,SOFTWARE PRACTICES AND TESTING ,Pass,33,16,49,BUSINESS INTELLIGENCE ,Pass,44,16,60,J2EE ,Pass,40,18,58,J2EE AND SOFTWARE TESTING LABORATORY,Pass,77,18,95,PROJECT AND VIVA VOCE ,Pass,233,57,290
M1613011, College : 4361  -  D M S M COLLEGE OF COMPUTER APPLICATION  BELAGAVI,DISTI,81.43,SOFTWARE PRACTICES AND TESTING ,Pass,52,20,72,BUSINESS INTELLIGENCE ,Pass,67,20,87,J2EE ,Pass,48,20,68,J2EE AND SOFTWARE TESTING LABORATORY,Pass,79,20,99,PROJECT AND VIVA VOCE ,Pass,235,58,293
M1613014, College : 4361  -  D M S M COLLEGE OF COMPUTER APPLICATION  BELAGAVI,DISTI,78.19,SOFTWARE PRACTICES AND TESTING ,Pass,32,19,51,BUSINESS INTELLIGENCE ,Pass,57,19,76,J2EE ,Pass,54,20,74,J2EE AND SOFTWARE TESTING LABORATORY,Pass,78,20,98,PROJECT AND VIVA VOCE ,Pass,235,58,293
M1613015, College : 4361  -  D M S M COLLEGE OF COMPUTER APPLICATION  BELAGAVI,FAIL,77.86,SOFTWARE PRACTICES AND TESTING ,Fail,20,18,38,BUSINESS INTELLIGENCE ,Pass,46,18,64,J2EE ,Pass,32,20,52,J2EE AND SOFTWARE TESTING LABORATORY,Pass,78,20,98,PROJECT AND VIVA VOCE ,Pass,235,58,293
M1613016, College : 4361  -  D M S M COLLEGE OF COMPUTER APPLICATION  BELAGAVI,DISTI,81.08,SOFTWARE PRACTICES AND TESTING ,Pass,33,19,52,BUSINESS INTELLIGENCE ,Pass,56,19,75,J2EE ,Pass,52,19,71,J2EE AND SOFTWARE TESTING LABORATORY,Pass,78,20,98,PROJECT AND VIVA VOCE ,Pass,234,58,292
M1613017, College : 4361  -  D M S M COLLEGE OF COMPUTER APPLICATION  BELAGAVI,DISTI,81.97,SOFTWARE PRACTICES AND TESTING ,Pass,56,20,76,BUSINESS INTELLIGENCE ,Pass,56,20,76,J2EE ,Pass,49,20,69,J2EE AND SOFTWARE TESTING LABORATORY,Pass,79,20,99,PROJECT AND VIVA VOCE ,Pass,235,58,293
M1613018, College : 4361  -  D M S M COLLEGE OF COMPUTER APPLICATION  BELAGAVI,FAIL,71.86,SOFTWARE PRACTICES AND TESTING ,Fail,20,15,35,BUSINESS INTELLIGENCE ,Pass,37,15,52,J2EE ,Pass,32,15,47,J2EE AND SOFTWARE TESTING LABORATORY,Pass,72,15,87,PROJECT AND VIVA VOCE ,Pass,230,52,282
M1613019, College : 4361  -  D M S M COLLEGE OF COMPUTER APPLICATION  BELAGAVI,FAIL,71.43,SOFTWARE PRACTICES AND TESTING ,Fail,20,15,35,BUSINESS INTELLIGENCE ,Pass,32,15,47,J2EE ,Pass,32,15,47,J2EE AND SOFTWARE TESTING LABORATORY,Pass,72,15,87,PROJECT AND VIVA VOCE ,Pass,230,54,284
M1613020, College : 4361  -  D M S M COLLEGE OF COMPUTER APPLICATION  BELAGAVI,DISTI,80.3,SOFTWARE PRACTICES AND TESTING ,Pass,56,20,76,BUSINESS INTELLIGENCE ,Pass,62,20,82,J2EE ,Pass,44,20,64,J2EE AND SOFTWARE TESTING LABORATORY,Pass,79,20,99,PROJECT AND VIVA VOCE ,Pass,235,58,293
M1613021, College : 4361  -  D M S M COLLEGE OF COMPUTER APPLICATION  BELAGAVI,DISTI,78.08,SOFTWARE PRACTICES AND TESTING ,Pass,44,19,63,BUSINESS INTELLIGENCE ,Pass,35,19,54,J2EE ,Pass,41,19,60,J2EE AND SOFTWARE TESTING LABORATORY,Pass,79,19,98,PROJECT AND VIVA VOCE ,Pass,236,58,294
M1613201, College : 4366  -  SRI SIDDALINGESHWARA B.C.A.COLLEGE  GOKAK,1ST C,65.05,SOFTWARE PRACTICES AND TESTING ,Pass,32,17,49,BUSINESS INTELLIGENCE ,Pass,53,12,65,J2EE ,Pass,37,16,53,J2EE AND SOFTWARE TESTING LABORATORY,Pass,62,15,77,PROJECT AND VIVA VOCE ,Pass,202,52,254
M1613202, College : 4366  -  SRI SIDDALINGESHWARA B.C.A.COLLEGE  GOKAK,FAIL,66.29,SOFTWARE PRACTICES AND TESTING ,Fail,10,17,27,BUSINESS INTELLIGENCE ,Pass,34,17,51,J2EE ,Pass,40,14,54,J2EE AND SOFTWARE TESTING LABORATORY,Pass,50,18,68,PROJECT AND VIVA VOCE ,Pass,211,53,264
M1613205, College : 4366  -  SRI SIDDALINGESHWARA B.C.A.COLLEGE  GOKAK,N.C.L,--   ,SOFTWARE PRACTICES AND TESTING ,Pass,44,8,52,BUSINESS INTELLIGENCE ,Pass,49,11,60,J2EE ,Pass,43,8,51,J2EE AND SOFTWARE TESTING LABORATORY,Pass,71,4,75,PROJECT AND VIVA VOCE ,Pass,189,49,238
M1613207, College : 4366  -  SRI SIDDALINGESHWARA B.C.A.COLLEGE  GOKAK,FAIL,55,SOFTWARE PRACTICES AND TESTING ,Pass,39,8,47,BUSINESS INTELLIGENCE ,Pass,46,8,54,J2EE ,Fail,18,9,27,J2EE AND SOFTWARE TESTING LABORATORY,Pass,68,14,82,PROJECT AND VIVA VOCE ,Pass,140,35,175
M1613208, College : 4366  -  SRI SIDDALINGESHWARA B.C.A.COLLEGE  GOKAK,2ND C,58.81,SOFTWARE PRACTICES AND TESTING ,Pass,61,8,69,BUSINESS INTELLIGENCE ,Pass,54,8,62,J2EE ,Pass,42,8,50,J2EE AND SOFTWARE TESTING LABORATORY,Pass,42,4,46,PROJECT AND VIVA VOCE ,Pass,185,34,219
M1613209, College : 4366  -  SRI SIDDALINGESHWARA B.C.A.COLLEGE  GOKAK,N.C.L,--   ,SOFTWARE PRACTICES AND TESTING ,Pass,52,10,62,BUSINESS INTELLIGENCE ,Pass,32,8,40,J2EE ,Pass,36,8,44,J2EE AND SOFTWARE TESTING LABORATORY,Pass,58,8,66,PROJECT AND VIVA VOCE ,Pass,201,40,241
M1613401, College : 5204  -  S B ARTS & KCP SCIENCE COLLEGE  VIJAYAPURA,N.C.L,--   ,SOFTWARE PRACTICES AND TESTING ,Pass,32,9,41,BUSINESS INTELLIGENCE ,Pass,53,13,66,J2EE ,Pass,32,10,42,J2EE AND SOFTWARE TESTING LABORATORY,Pass,44,8,52,PROJECT AND VIVA VOCE ,Pass,187,40,227
M1613402, College : 5204  -  S B ARTS & KCP SCIENCE COLLEGE  VIJAYAPURA,2ND C,59.24,SOFTWARE PRACTICES AND TESTING ,Pass,43,11,54,BUSINESS INTELLIGENCE ,Pass,66,16,82,J2EE ,Pass,32,9,41,J2EE AND SOFTWARE TESTING LABORATORY,Pass,58,14,72,PROJECT AND VIVA VOCE ,Pass,183,40,223
M1613403, College : 5204  -  S B ARTS & KCP SCIENCE COLLEGE  VIJAYAPURA,FAIL,62.71,SOFTWARE PRACTICES AND TESTING ,Pass,32,9,41,BUSINESS INTELLIGENCE ,Pass,48,15,63,J2EE ,Fail,13,9,22,J2EE AND SOFTWARE TESTING LABORATORY,Pass,46,11,57,PROJECT AND VIVA VOCE ,Pass,208,48,256
M1613404, College : 5204  -  S B ARTS & KCP SCIENCE COLLEGE  VIJAYAPURA,FAIL,63.14,SOFTWARE PRACTICES AND TESTING ,Pass,32,12,44,BUSINESS INTELLIGENCE ,Fail,13,15,28,J2EE ,Pass,33,12,45,J2EE AND SOFTWARE TESTING LABORATORY,Pass,75,14,89,PROJECT AND VIVA VOCE ,Pass,194,42,236
M1613405, College : 5204  -  S B ARTS & KCP SCIENCE COLLEGE  VIJAYAPURA,N.C.L,--   ,SOFTWARE PRACTICES AND TESTING ,Pass,33,13,46,BUSINESS INTELLIGENCE ,Pass,45,17,62,J2EE ,Pass,32,14,46,J2EE AND SOFTWARE TESTING LABORATORY,Pass,68,12,80,PROJECT AND VIVA VOCE ,Pass,218,51,269
M1613406, College : 5204  -  S B ARTS & KCP SCIENCE COLLEGE  VIJAYAPURA,FAIL,68.71,SOFTWARE PRACTICES AND TESTING ,Pass,36,10,46,BUSINESS INTELLIGENCE ,Pass,52,17,69,J2EE ,Fail,20,12,32,J2EE AND SOFTWARE TESTING LABORATORY,Pass,49,11,60,PROJECT AND VIVA VOCE ,Pass,222,52,274
M1613407, College : 5204  -  S B ARTS & KCP SCIENCE COLLEGE  VIJAYAPURA,DISTI,81.54,SOFTWARE PRACTICES AND TESTING ,Pass,66,18,84,BUSINESS INTELLIGENCE ,Pass,71,20,91,J2EE ,Pass,54,18,72,J2EE AND SOFTWARE TESTING LABORATORY,Pass,70,19,89,PROJECT AND VIVA VOCE ,Pass,216,55,271
M1613409, College : 5204  -  S B ARTS & KCP SCIENCE COLLEGE  VIJAYAPURA,DISTI,82.92,SOFTWARE PRACTICES AND TESTING ,Pass,47,17,64,BUSINESS INTELLIGENCE ,Pass,77,18,95,J2EE ,Pass,40,16,56,J2EE AND SOFTWARE TESTING LABORATORY,Pass,71,17,88,PROJECT AND VIVA VOCE ,Pass,195,55,250
M1613410, College : 5204  -  S B ARTS & KCP SCIENCE COLLEGE  VIJAYAPURA,DISTI,86.22,SOFTWARE PRACTICES AND TESTING ,Pass,68,20,88,BUSINESS INTELLIGENCE ,Pass,70,20,90,J2EE ,Pass,71,19,90,J2EE AND SOFTWARE TESTING LABORATORY,Pass,76,18,94,PROJECT AND VIVA VOCE ,Pass,210,56,266
M1613411, College : 5204  -  S B ARTS & KCP SCIENCE COLLEGE  VIJAYAPURA,N.C.L,--   ,SOFTWARE PRACTICES AND TESTING ,Pass,47,15,62,BUSINESS INTELLIGENCE ,Pass,55,18,73,J2EE ,Pass,43,17,60,J2EE AND SOFTWARE TESTING LABORATORY,Pass,74,18,92,PROJECT AND VIVA VOCE ,Pass,196,50,246
M1613412, College : 5204  -  S B ARTS & KCP SCIENCE COLLEGE  VIJAYAPURA,1ST C,66.51,SOFTWARE PRACTICES AND TESTING ,Pass,68,16,84,BUSINESS INTELLIGENCE ,Pass,46,18,64,J2EE ,Pass,37,14,51,J2EE AND SOFTWARE TESTING LABORATORY,Pass,62,14,76,PROJECT AND VIVA VOCE ,Pass,189,49,238
M1613413, College : 5204  -  S B ARTS & KCP SCIENCE COLLEGE  VIJAYAPURA,N.C.L,--   ,SOFTWARE PRACTICES AND TESTING ,Pass,50,13,63,BUSINESS INTELLIGENCE ,Pass,40,16,56,J2EE ,Pass,59,14,73,J2EE AND SOFTWARE TESTING LABORATORY,Pass,78,19,97,PROJECT AND VIVA VOCE ,Pass,211,56,267
M1613414, College : 5204  -  S B ARTS & KCP SCIENCE COLLEGE  VIJAYAPURA,DISTI,72.16,SOFTWARE PRACTICES AND TESTING ,Pass,58,16,74,BUSINESS INTELLIGENCE ,Pass,46,18,64,J2EE ,Pass,40,17,57,J2EE AND SOFTWARE TESTING LABORATORY,Pass,61,17,78,PROJECT AND VIVA VOCE ,Pass,214,50,264
M1613415, College : 5204  -  S B ARTS & KCP SCIENCE COLLEGE  VIJAYAPURA,DISTI,78.97,SOFTWARE PRACTICES AND TESTING ,Pass,71,15,86,BUSINESS INTELLIGENCE ,Pass,69,19,88,J2EE ,Pass,53,18,71,J2EE AND SOFTWARE TESTING LABORATORY,Pass,70,19,89,PROJECT AND VIVA VOCE ,Pass,201,51,252
M1613416, College : 5204  -  S B ARTS & KCP SCIENCE COLLEGE  VIJAYAPURA,DISTI,78.62,SOFTWARE PRACTICES AND TESTING ,Pass,67,15,82,BUSINESS INTELLIGENCE ,Pass,68,19,87,J2EE ,Pass,53,18,71,J2EE AND SOFTWARE TESTING LABORATORY,Pass,74,18,92,PROJECT AND VIVA VOCE ,Pass,230,55,285
M1613417, College : 5204  -  S B ARTS & KCP SCIENCE COLLEGE  VIJAYAPURA,DISTI,87.76,SOFTWARE PRACTICES AND TESTING ,Pass,71,19,90,BUSINESS INTELLIGENCE ,Pass,74,20,94,J2EE ,Pass,60,20,80,J2EE AND SOFTWARE TESTING LABORATORY,Pass,72,18,90,PROJECT AND VIVA VOCE ,Pass,218,56,274
M1613418, College : 5204  -  S B ARTS & KCP SCIENCE COLLEGE  VIJAYAPURA,N.C.L,--   ,SOFTWARE PRACTICES AND TESTING ,Pass,54,12,66,BUSINESS INTELLIGENCE ,Pass,41,19,60,J2EE ,Pass,48,13,61,J2EE AND SOFTWARE TESTING LABORATORY,Pass,60,15,75,PROJECT AND VIVA VOCE ,Pass,211,52,263
M1613419, College : 5204  -  S B ARTS & KCP SCIENCE COLLEGE  VIJAYAPURA,DISTI,70.11,SOFTWARE PRACTICES AND TESTING ,Pass,70,17,87,BUSINESS INTELLIGENCE ,Pass,69,20,89,J2EE ,Pass,64,18,82,J2EE AND SOFTWARE TESTING LABORATORY,Pass,70,17,87,PROJECT AND VIVA VOCE ,Pass,196,49,245
M1613420, College : 5204  -  S B ARTS & KCP SCIENCE COLLEGE  VIJAYAPURA,DISTI,79.27,SOFTWARE PRACTICES AND TESTING ,Pass,68,17,85,BUSINESS INTELLIGENCE ,Pass,70,20,90,J2EE ,Pass,74,19,93,J2EE AND SOFTWARE TESTING LABORATORY,Pass,75,18,93,PROJECT AND VIVA VOCE ,Pass,190,50,240
M1613421, College : 5204  -  S B ARTS & KCP SCIENCE COLLEGE  VIJAYAPURA,DISTI,74.05,SOFTWARE PRACTICES AND TESTING ,Pass,60,17,77,BUSINESS INTELLIGENCE ,Pass,53,19,72,J2EE ,Pass,49,18,67,J2EE AND SOFTWARE TESTING LABORATORY,Pass,69,17,86,PROJECT AND VIVA VOCE ,Pass,195,50,245
M1613422, College : 5204  -  S B ARTS & KCP SCIENCE COLLEGE  VIJAYAPURA,N.C.L,--   ,SOFTWARE PRACTICES AND TESTING ,Pass,54,13,67,BUSINESS INTELLIGENCE ,Pass,49,19,68,J2EE ,Pass,49,11,60,J2EE AND SOFTWARE TESTING LABORATORY,Pass,66,11,77,PROJECT AND VIVA VOCE ,Pass,224,53,277
M1613423, College : 5204  -  S B ARTS & KCP SCIENCE COLLEGE  VIJAYAPURA,DISTI,75.35,SOFTWARE PRACTICES AND TESTING ,Pass,76,18,94,BUSINESS INTELLIGENCE ,Pass,70,19,89,J2EE ,Pass,55,16,71,J2EE AND SOFTWARE TESTING LABORATORY,Pass,72,14,86,PROJECT AND VIVA VOCE ,Pass,128,50,178
M1613424, College : 5204  -  S B ARTS & KCP SCIENCE COLLEGE  VIJAYAPURA,DISTI,78.81,SOFTWARE PRACTICES AND TESTING ,Pass,69,17,86,BUSINESS INTELLIGENCE ,Pass,66,19,85,J2EE ,Pass,52,19,71,J2EE AND SOFTWARE TESTING LABORATORY,Pass,74,19,93,PROJECT AND VIVA VOCE ,Pass,210,57,267
M1613425, College : 5204  -  S B ARTS & KCP SCIENCE COLLEGE  VIJAYAPURA,FAIL,65.57,SOFTWARE PRACTICES AND TESTING ,Fail,19,10,29,BUSINESS INTELLIGENCE ,Pass,63,10,73,J2EE ,Pass,32,8,40,J2EE AND SOFTWARE TESTING LABORATORY,Pass,68,14,82,PROJECT AND VIVA VOCE ,Pass,193,42,235
M1613426, College : 5204  -  S B ARTS & KCP SCIENCE COLLEGE  VIJAYAPURA,DISTI,89.73,SOFTWARE PRACTICES AND TESTING ,Pass,72,19,91,BUSINESS INTELLIGENCE ,Pass,75,20,95,J2EE ,Pass,73,18,91,J2EE AND SOFTWARE TESTING LABORATORY,Pass,78,18,96,PROJECT AND VIVA VOCE ,Pass,227,58,285
M1613427, College : 5204  -  S B ARTS & KCP SCIENCE COLLEGE  VIJAYAPURA,1ST C,68.81,SOFTWARE PRACTICES AND TESTING ,Pass,47,15,62,BUSINESS INTELLIGENCE ,Pass,47,16,63,J2EE ,Pass,52,15,67,J2EE AND SOFTWARE TESTING LABORATORY,Pass,74,20,94,PROJECT AND VIVA VOCE ,Pass,193,51,244
M1613428, College : 5204  -  S B ARTS & KCP SCIENCE COLLEGE  VIJAYAPURA,N.C.L,--   ,SOFTWARE PRACTICES AND TESTING ,Pass,40,13,53,BUSINESS INTELLIGENCE ,Pass,44,15,59,J2EE ,Pass,35,15,50,J2EE AND SOFTWARE TESTING LABORATORY,Pass,72,17,89,PROJECT AND VIVA VOCE ,Pass,195,42,237
M1613429, College : 5204  -  S B ARTS & KCP SCIENCE COLLEGE  VIJAYAPURA,1ST C,61.38,SOFTWARE PRACTICES AND TESTING ,Pass,68,15,83,BUSINESS INTELLIGENCE ,Pass,60,20,80,J2EE ,Pass,40,17,57,J2EE AND SOFTWARE TESTING LABORATORY,Pass,52,16,68,PROJECT AND VIVA VOCE ,Pass,187,42,229
M1613430, College : 5204  -  S B ARTS & KCP SCIENCE COLLEGE  VIJAYAPURA,FAIL,62.43,SOFTWARE PRACTICES AND TESTING ,Pass,40,12,52,BUSINESS INTELLIGENCE ,Pass,39,16,55,J2EE ,Fail,13,12,25,J2EE AND SOFTWARE TESTING LABORATORY,Pass,52,14,66,PROJECT AND VIVA VOCE ,Pass,194,45,239
M1613431, College : 5204  -  S B ARTS & KCP SCIENCE COLLEGE  VIJAYAPURA,DISTI,79.78,SOFTWARE PRACTICES AND TESTING ,Pass,73,16,89,BUSINESS INTELLIGENCE ,Pass,59,18,77,J2EE ,Pass,40,11,51,J2EE AND SOFTWARE TESTING LABORATORY,Pass,78,18,96,PROJECT AND VIVA VOCE ,Pass,200,49,249
M1613432, College : 5204  -  S B ARTS & KCP SCIENCE COLLEGE  VIJAYAPURA,FAIL,69.29,SOFTWARE PRACTICES AND TESTING ,Pass,50,10,60,BUSINESS INTELLIGENCE ,Pass,49,17,66,J2EE ,Fail,23,12,35,J2EE AND SOFTWARE TESTING LABORATORY,Pass,59,13,72,PROJECT AND VIVA VOCE ,Pass,205,47,252
M1613433, College : 5204  -  S B ARTS & KCP SCIENCE COLLEGE  VIJAYAPURA,1ST C,69.41,SOFTWARE PRACTICES AND TESTING ,Pass,71,15,86,BUSINESS INTELLIGENCE ,Pass,61,19,80,J2EE ,Pass,46,17,63,J2EE AND SOFTWARE TESTING LABORATORY,Pass,70,15,85,PROJECT AND VIVA VOCE ,Pass,214,52,266
M1613434, College : 5204  -  S B ARTS & KCP SCIENCE COLLEGE  VIJAYAPURA,1ST C,66.41,SOFTWARE PRACTICES AND TESTING ,Pass,57,15,72,BUSINESS INTELLIGENCE ,Pass,68,14,82,J2EE ,Pass,48,16,64,J2EE AND SOFTWARE TESTING LABORATORY,Pass,57,15,72,PROJECT AND VIVA VOCE ,Pass,130,51,181
M1613436, College : 5204  -  S B ARTS & KCP SCIENCE COLLEGE  VIJAYAPURA,DISTI,76.43,SOFTWARE PRACTICES AND TESTING ,Pass,42,12,54,BUSINESS INTELLIGENCE ,Pass,41,13,54,J2EE ,Pass,50,13,63,J2EE AND SOFTWARE TESTING LABORATORY,Pass,77,18,95,PROJECT AND VIVA VOCE ,Pass,227,53,280
M1613437, College : 5204  -  S B ARTS & KCP SCIENCE COLLEGE  VIJAYAPURA,1ST C,68.27,SOFTWARE PRACTICES AND TESTING ,Pass,44,15,59,BUSINESS INTELLIGENCE ,Pass,67,19,86,J2EE ,Pass,45,13,58,J2EE AND SOFTWARE TESTING LABORATORY,Pass,61,11,72,PROJECT AND VIVA VOCE ,Pass,187,48,235
M1613438, College : 5204  -  S B ARTS & KCP SCIENCE COLLEGE  VIJAYAPURA,1ST C,68.54,SOFTWARE PRACTICES AND TESTING ,Pass,32,11,43,BUSINESS INTELLIGENCE ,Pass,55,20,75,J2EE ,Pass,33,14,47,J2EE AND SOFTWARE TESTING LABORATORY,Pass,79,15,94,PROJECT AND VIVA VOCE ,Pass,213,50,263
M1613439, College : 5204  -  S B ARTS & KCP SCIENCE COLLEGE  VIJAYAPURA,N.C.L,--   ,SOFTWARE PRACTICES AND TESTING ,Pass,37,14,51,BUSINESS INTELLIGENCE ,Pass,49,19,68,J2EE ,Pass,41,17,58,J2EE AND SOFTWARE TESTING LABORATORY,Pass,72,17,89,PROJECT AND VIVA VOCE ,Pass,190,46,236
M1613440, College : 5204  -  S B ARTS & KCP SCIENCE COLLEGE  VIJAYAPURA,N.C.L,--   ,SOFTWARE PRACTICES AND TESTING ,Pass,32,14,46,BUSINESS INTELLIGENCE ,Pass,43,15,58,J2EE ,Pass,36,11,47,J2EE AND SOFTWARE TESTING LABORATORY,Pass,40,13,53,PROJECT AND VIVA VOCE ,Pass,140,54,194
M1613441, College : 5204  -  S B ARTS & KCP SCIENCE COLLEGE  VIJAYAPURA,DISTI,82.81,SOFTWARE PRACTICES AND TESTING ,Pass,63,19,82,BUSINESS INTELLIGENCE ,Pass,61,20,81,J2EE ,Pass,34,18,52,J2EE AND SOFTWARE TESTING LABORATORY,Pass,74,17,91,PROJECT AND VIVA VOCE ,Pass,215,52,267
M1613442, College : 5204  -  S B ARTS & KCP SCIENCE COLLEGE  VIJAYAPURA,DISTI,91.08,SOFTWARE PRACTICES AND TESTING ,Pass,70,18,88,BUSINESS INTELLIGENCE ,Pass,73,16,89,J2EE ,Pass,53,20,73,J2EE AND SOFTWARE TESTING LABORATORY,Pass,78,19,97,PROJECT AND VIVA VOCE ,Pass,223,52,275
M1613446, College : 5204  -  S B ARTS & KCP SCIENCE COLLEGE  VIJAYAPURA,DISTI,70.24,SOFTWARE PRACTICES AND TESTING ,Pass,57,17,74,BUSINESS INTELLIGENCE ,Pass,62,20,82,J2EE ,Pass,32,17,49,J2EE AND SOFTWARE TESTING LABORATORY,Pass,65,18,83,PROJECT AND VIVA VOCE ,Pass,199,50,249
M1613447, College : 5204  -  S B ARTS & KCP SCIENCE COLLEGE  VIJAYAPURA,1ST C,68.38,SOFTWARE PRACTICES AND TESTING ,Pass,48,18,66,BUSINESS INTELLIGENCE ,Pass,60,18,78,J2EE ,Pass,32,14,46,J2EE AND SOFTWARE TESTING LABORATORY,Pass,63,14,77,PROJECT AND VIVA VOCE ,Pass,202,45,247
M1613448, College : 5204  -  S B ARTS & KCP SCIENCE COLLEGE  VIJAYAPURA,FAIL,69.29,SOFTWARE PRACTICES AND TESTING ,Pass,45,12,57,BUSINESS INTELLIGENCE ,Pass,55,18,73,J2EE ,Fail,21,12,33,J2EE AND SOFTWARE TESTING LABORATORY,Pass,67,19,86,PROJECT AND VIVA VOCE ,Pass,190,46,236
M1613449, College : 5204  -  S B ARTS & KCP SCIENCE COLLEGE  VIJAYAPURA,DISTI,75.49,SOFTWARE PRACTICES AND TESTING ,Pass,47,16,63,BUSINESS INTELLIGENCE ,Pass,63,19,82,J2EE ,Pass,32,14,46,J2EE AND SOFTWARE TESTING LABORATORY,Pass,70,18,88,PROJECT AND VIVA VOCE ,Pass,200,50,250
M1613450, College : 5204  -  S B ARTS & KCP SCIENCE COLLEGE  VIJAYAPURA,DISTI,82.32,SOFTWARE PRACTICES AND TESTING ,Pass,61,20,81,BUSINESS INTELLIGENCE ,Pass,72,20,92,J2EE ,Pass,50,17,67,J2EE AND SOFTWARE TESTING LABORATORY,Pass,78,16,94,PROJECT AND VIVA VOCE ,Pass,180,57,237
M1613451, College : 5204  -  S B ARTS & KCP SCIENCE COLLEGE  VIJAYAPURA,1ST C,67.68,SOFTWARE PRACTICES AND TESTING ,Pass,39,15,54,BUSINESS INTELLIGENCE ,Pass,65,19,84,J2EE ,Pass,47,18,65,J2EE AND SOFTWARE TESTING LABORATORY,Pass,69,16,85,PROJECT AND VIVA VOCE ,Pass,198,51,249
M1613452, College : 5204  -  S B ARTS & KCP SCIENCE COLLEGE  VIJAYAPURA,1ST C,67.57,SOFTWARE PRACTICES AND TESTING ,Pass,41,10,51,BUSINESS INTELLIGENCE ,Pass,70,17,87,J2EE ,Pass,33,10,43,J2EE AND SOFTWARE TESTING LABORATORY,Pass,68,16,84,PROJECT AND VIVA VOCE ,Pass,165,49,214
M1613454, College : 5204  -  S B ARTS & KCP SCIENCE COLLEGE  VIJAYAPURA,DISTI,86.27,SOFTWARE PRACTICES AND TESTING ,Pass,58,18,76,BUSINESS INTELLIGENCE ,Pass,73,19,92,J2EE ,Pass,45,17,62,J2EE AND SOFTWARE TESTING LABORATORY,Pass,71,16,87,PROJECT AND VIVA VOCE ,Pass,222,57,279
M1613455, College : 5204  -  S B ARTS & KCP SCIENCE COLLEGE  VIJAYAPURA,DISTI,90.32,SOFTWARE PRACTICES AND TESTING ,Pass,70,19,89,BUSINESS INTELLIGENCE ,Pass,79,19,98,J2EE ,Pass,74,20,94,J2EE AND SOFTWARE TESTING LABORATORY,Pass,80,18,98,PROJECT AND VIVA VOCE ,Pass,227,59,286
M1613457, College : 5204  -  S B ARTS & KCP SCIENCE COLLEGE  VIJAYAPURA,DISTI,78.35,SOFTWARE PRACTICES AND TESTING ,Pass,62,15,77,BUSINESS INTELLIGENCE ,Pass,52,19,71,J2EE ,Pass,38,16,54,J2EE AND SOFTWARE TESTING LABORATORY,Pass,80,15,95,PROJECT AND VIVA VOCE ,Pass,227,55,282
M1613458, College : 5204  -  S B ARTS & KCP SCIENCE COLLEGE  VIJAYAPURA,DISTI,80.95,SOFTWARE PRACTICES AND TESTING ,Pass,60,13,73,BUSINESS INTELLIGENCE ,Pass,59,19,78,J2EE ,Pass,40,17,57,J2EE AND SOFTWARE TESTING LABORATORY,Pass,72,15,87,PROJECT AND VIVA VOCE ,Pass,227,54,281
M1613459, College : 5204  -  S B ARTS & KCP SCIENCE COLLEGE  VIJAYAPURA,FAIL,71.29,SOFTWARE PRACTICES AND TESTING ,Pass,60,10,70,BUSINESS INTELLIGENCE ,Pass,60,18,78,J2EE ,Fail,19,12,31,J2EE AND SOFTWARE TESTING LABORATORY,Pass,60,14,74,PROJECT AND VIVA VOCE ,Pass,197,49,246
M1613460, College : 5204  -  S B ARTS & KCP SCIENCE COLLEGE  VIJAYAPURA,FAIL,63.43,SOFTWARE PRACTICES AND TESTING ,Pass,43,13,56,BUSINESS INTELLIGENCE ,Pass,43,17,60,J2EE ,Fail,15,11,26,J2EE AND SOFTWARE TESTING LABORATORY,Pass,62,15,77,PROJECT AND VIVA VOCE ,Pass,183,42,225
M1613461, College : 5204  -  S B ARTS & KCP SCIENCE COLLEGE  VIJAYAPURA,N.C.L,--   ,SOFTWARE PRACTICES AND TESTING ,Pass,61,10,71,BUSINESS INTELLIGENCE ,Pass,56,14,70,J2EE ,Pass,32,11,43,J2EE AND SOFTWARE TESTING LABORATORY,Pass,37,8,45,PROJECT AND VIVA VOCE ,Pass,200,42,242
M1613462, College : 5204  -  S B ARTS & KCP SCIENCE COLLEGE  VIJAYAPURA,N.C.L,--   ,SOFTWARE PRACTICES AND TESTING ,Pass,68,15,83,BUSINESS INTELLIGENCE ,Pass,72,18,90,J2EE ,Pass,54,13,67,J2EE AND SOFTWARE TESTING LABORATORY,Pass,60,9,69,PROJECT AND VIVA VOCE ,Pass,208,50,258
M1613463, College : 5204  -  S B ARTS & KCP SCIENCE COLLEGE  VIJAYAPURA,DISTI,89.84,SOFTWARE PRACTICES AND TESTING ,Pass,76,20,96,BUSINESS INTELLIGENCE ,Pass,78,20,98,J2EE ,Pass,67,20,87,J2EE AND SOFTWARE TESTING LABORATORY,Pass,80,19,99,PROJECT AND VIVA VOCE ,Pass,230,58,288
M1613464, College : 5204  -  S B ARTS & KCP SCIENCE COLLEGE  VIJAYAPURA,DISTI,74.32,SOFTWARE PRACTICES AND TESTING ,Pass,64,18,82,BUSINESS INTELLIGENCE ,Pass,69,19,88,J2EE ,Pass,36,14,50,J2EE AND SOFTWARE TESTING LABORATORY,Pass,67,16,83,PROJECT AND VIVA VOCE ,Pass,220,58,278
M1613465, College : 5204  -  S B ARTS & KCP SCIENCE COLLEGE  VIJAYAPURA,FAIL,70.14,SOFTWARE PRACTICES AND TESTING ,Pass,42,11,53,BUSINESS INTELLIGENCE ,Pass,54,18,72,J2EE ,Fail,17,11,28,J2EE AND SOFTWARE TESTING LABORATORY,Pass,67,13,80,PROJECT AND VIVA VOCE ,Pass,208,50,258
M1613466, College : 5204  -  S B ARTS & KCP SCIENCE COLLEGE  VIJAYAPURA,1ST C,66.7,SOFTWARE PRACTICES AND TESTING ,Pass,53,14,67,BUSINESS INTELLIGENCE ,Pass,64,18,82,J2EE ,Pass,43,16,59,J2EE AND SOFTWARE TESTING LABORATORY,Pass,61,17,78,PROJECT AND VIVA VOCE ,Pass,175,51,226
M1613467, College : 5204  -  S B ARTS & KCP SCIENCE COLLEGE  VIJAYAPURA,DISTI,70,SOFTWARE PRACTICES AND TESTING ,Pass,62,15,77,BUSINESS INTELLIGENCE ,Pass,63,17,80,J2EE ,Pass,32,16,48,J2EE AND SOFTWARE TESTING LABORATORY,Pass,64,17,81,PROJECT AND VIVA VOCE ,Pass,158,49,207
M1613468, College : 5204  -  S B ARTS & KCP SCIENCE COLLEGE  VIJAYAPURA,DISTI,72,SOFTWARE PRACTICES AND TESTING ,Pass,50,16,66,BUSINESS INTELLIGENCE ,Pass,69,18,87,J2EE ,Pass,37,14,51,J2EE AND SOFTWARE TESTING LABORATORY,Pass,66,12,78,PROJECT AND VIVA VOCE ,Pass,177,47,224
M1613469, College : 5204  -  S B ARTS & KCP SCIENCE COLLEGE  VIJAYAPURA,DISTI,71.46,SOFTWARE PRACTICES AND TESTING ,Pass,60,16,76,BUSINESS INTELLIGENCE ,Pass,63,20,83,J2EE ,Pass,36,13,49,J2EE AND SOFTWARE TESTING LABORATORY,Pass,58,12,70,PROJECT AND VIVA VOCE ,Pass,177,47,224
M1613470, College : 5204  -  S B ARTS & KCP SCIENCE COLLEGE  VIJAYAPURA,DISTI,72.54,SOFTWARE PRACTICES AND TESTING ,Pass,43,16,59,BUSINESS INTELLIGENCE ,Pass,71,19,90,J2EE ,Pass,35,16,51,J2EE AND SOFTWARE TESTING LABORATORY,Pass,63,14,77,PROJECT AND VIVA VOCE ,Pass,177,48,225
M1613471, College : 5204  -  S B ARTS & KCP SCIENCE COLLEGE  VIJAYAPURA,N.C.L,--   ,SOFTWARE PRACTICES AND TESTING ,Pass,56,12,68,BUSINESS INTELLIGENCE ,Pass,61,16,77,J2EE ,Pass,47,13,60,J2EE AND SOFTWARE TESTING LABORATORY,Pass,72,10,82,PROJECT AND VIVA VOCE ,Pass,202,45,247
M1613472, College : 5204  -  S B ARTS & KCP SCIENCE COLLEGE  VIJAYAPURA,DISTI,72.32,SOFTWARE PRACTICES AND TESTING ,Pass,59,16,75,BUSINESS INTELLIGENCE ,Pass,69,19,88,J2EE ,Pass,43,14,57,J2EE AND SOFTWARE TESTING LABORATORY,Pass,75,16,91,PROJECT AND VIVA VOCE ,Pass,202,45,247
M1613473, College : 5204  -  S B ARTS & KCP SCIENCE COLLEGE  VIJAYAPURA,DISTI,74.24,SOFTWARE PRACTICES AND TESTING ,Pass,56,15,71,BUSINESS INTELLIGENCE ,Pass,53,19,72,J2EE ,Pass,43,14,57,J2EE AND SOFTWARE TESTING LABORATORY,Pass,76,16,92,PROJECT AND VIVA VOCE ,Pass,200,50,250
M1613475, College : 5204  -  S B ARTS & KCP SCIENCE COLLEGE  VIJAYAPURA,DISTI,75.38,SOFTWARE PRACTICES AND TESTING ,Pass,63,12,75,BUSINESS INTELLIGENCE ,Pass,70,16,86,J2EE ,Pass,47,10,57,J2EE AND SOFTWARE TESTING LABORATORY,Pass,73,11,84,PROJECT AND VIVA VOCE ,Pass,210,50,260
M1613476, College : 5204  -  S B ARTS & KCP SCIENCE COLLEGE  VIJAYAPURA,DISTI,77.38,SOFTWARE PRACTICES AND TESTING ,Pass,62,17,79,BUSINESS INTELLIGENCE ,Pass,63,20,83,J2EE ,Pass,56,14,70,J2EE AND SOFTWARE TESTING LABORATORY,Pass,74,17,91,PROJECT AND VIVA VOCE ,Pass,204,57,261
M1613477, College : 5204  -  S B ARTS & KCP SCIENCE COLLEGE  VIJAYAPURA,FAIL,71.71,SOFTWARE PRACTICES AND TESTING ,Pass,63,14,77,BUSINESS INTELLIGENCE ,Pass,48,18,66,J2EE ,Fail,21,12,33,J2EE AND SOFTWARE TESTING LABORATORY,Pass,58,18,76,PROJECT AND VIVA VOCE ,Pass,204,46,250
M1613478, College : 5204  -  S B ARTS & KCP SCIENCE COLLEGE  VIJAYAPURA,2ND C,58.43,SOFTWARE PRACTICES AND TESTING ,Pass,50,14,64,BUSINESS INTELLIGENCE ,Pass,50,19,69,J2EE ,Pass,37,12,49,J2EE AND SOFTWARE TESTING LABORATORY,Pass,72,16,88,PROJECT AND VIVA VOCE ,Pass,191,46,237
M1613479, College : 5204  -  S B ARTS & KCP SCIENCE COLLEGE  VIJAYAPURA,FAIL,67.14,SOFTWARE PRACTICES AND TESTING ,Pass,53,11,64,BUSINESS INTELLIGENCE ,Pass,49,15,64,J2EE ,Fail,20,10,30,J2EE AND SOFTWARE TESTING LABORATORY,Pass,53,11,64,PROJECT AND VIVA VOCE ,Pass,199,49,248
M1613480, College : 5204  -  S B ARTS & KCP SCIENCE COLLEGE  VIJAYAPURA,FAIL,49.43,SOFTWARE PRACTICES AND TESTING ,Fail,17,9,26,BUSINESS INTELLIGENCE ,Pass,32,14,46,J2EE ,Fail,7,10,17,J2EE AND SOFTWARE TESTING LABORATORY,Fail,12,10,22,PROJECT AND VIVA VOCE ,Pass,190,45,235
M1613601, College : 5207  -  SECAB INSTITUTE OF BUSINESS ADMINISTRATION  VIJAYAPURA,DISTI,72.57,SOFTWARE PRACTICES AND TESTING ,Pass,40,19,59,BUSINESS INTELLIGENCE ,Pass,62,14,76,J2EE ,Pass,39,19,58,J2EE AND SOFTWARE TESTING LABORATORY,Pass,72,16,88,PROJECT AND VIVA VOCE ,Pass,210,56,266
M1613602, College : 5207  -  SECAB INSTITUTE OF BUSINESS ADMINISTRATION  VIJAYAPURA,DISTI,73.41,SOFTWARE PRACTICES AND TESTING ,Pass,35,19,54,BUSINESS INTELLIGENCE ,Pass,70,15,85,J2EE ,Pass,45,19,64,J2EE AND SOFTWARE TESTING LABORATORY,Pass,72,17,89,PROJECT AND VIVA VOCE ,Pass,210,56,266
M1613603, College : 5207  -  SECAB INSTITUTE OF BUSINESS ADMINISTRATION  VIJAYAPURA,DISTI,76.97,SOFTWARE PRACTICES AND TESTING ,Pass,32,20,52,BUSINESS INTELLIGENCE ,Pass,66,17,83,J2EE ,Pass,42,20,62,J2EE AND SOFTWARE TESTING LABORATORY,Pass,74,19,93,PROJECT AND VIVA VOCE ,Pass,210,60,270
M1613604, College : 5207  -  SECAB INSTITUTE OF BUSINESS ADMINISTRATION  VIJAYAPURA,DISTI,71.84,SOFTWARE PRACTICES AND TESTING ,Pass,34,19,53,BUSINESS INTELLIGENCE ,Pass,62,12,74,J2EE ,Pass,35,20,55,J2EE AND SOFTWARE TESTING LABORATORY,Pass,70,19,89,PROJECT AND VIVA VOCE ,Pass,210,59,269
M1613605, College : 5207  -  SECAB INSTITUTE OF BUSINESS ADMINISTRATION  VIJAYAPURA,DISTI,82.57,SOFTWARE PRACTICES AND TESTING ,Pass,52,18,70,BUSINESS INTELLIGENCE ,Pass,76,16,92,J2EE ,Pass,39,19,58,J2EE AND SOFTWARE TESTING LABORATORY,Pass,64,18,82,PROJECT AND VIVA VOCE ,Pass,207,54,261
M1613606, College : 5207  -  SECAB INSTITUTE OF BUSINESS ADMINISTRATION  VIJAYAPURA,DISTI,79.27,SOFTWARE PRACTICES AND TESTING ,Pass,54,20,74,BUSINESS INTELLIGENCE ,Pass,67,16,83,J2EE ,Pass,38,20,58,J2EE AND SOFTWARE TESTING LABORATORY,Pass,72,20,92,PROJECT AND VIVA VOCE ,Pass,225,60,285
M1613607, College : 5207  -  SECAB INSTITUTE OF BUSINESS ADMINISTRATION  VIJAYAPURA,1ST C,66.59,SOFTWARE PRACTICES AND TESTING ,Pass,36,18,54,BUSINESS INTELLIGENCE ,Pass,61,12,73,J2EE ,Pass,32,16,48,J2EE AND SOFTWARE TESTING LABORATORY,Pass,64,13,77,PROJECT AND VIVA VOCE ,Pass,203,47,250
M1613608, College : 5207  -  SECAB INSTITUTE OF BUSINESS ADMINISTRATION  VIJAYAPURA,FAIL,63.57,SOFTWARE PRACTICES AND TESTING ,Fail,19,17,36,BUSINESS INTELLIGENCE ,Pass,49,12,61,J2EE ,Pass,34,17,51,J2EE AND SOFTWARE TESTING LABORATORY,Pass,60,15,75,PROJECT AND VIVA VOCE ,Pass,170,52,222
M1613609, College : 5207  -  SECAB INSTITUTE OF BUSINESS ADMINISTRATION  VIJAYAPURA,DISTI,85.51,SOFTWARE PRACTICES AND TESTING ,Pass,48,20,68,BUSINESS INTELLIGENCE ,Pass,72,20,92,J2EE ,Pass,50,20,70,J2EE AND SOFTWARE TESTING LABORATORY,Pass,75,20,95,PROJECT AND VIVA VOCE ,Pass,225,60,285
M1613611, College : 5207  -  SECAB INSTITUTE OF BUSINESS ADMINISTRATION  VIJAYAPURA,DISTI,74.22,SOFTWARE PRACTICES AND TESTING ,Pass,42,20,62,BUSINESS INTELLIGENCE ,Pass,57,14,71,J2EE ,Pass,43,18,61,J2EE AND SOFTWARE TESTING LABORATORY,Pass,60,18,78,PROJECT AND VIVA VOCE ,Pass,200,56,256
M1613612, College : 5207  -  SECAB INSTITUTE OF BUSINESS ADMINISTRATION  VIJAYAPURA,DISTI,88.81,SOFTWARE PRACTICES AND TESTING ,Pass,63,20,83,BUSINESS INTELLIGENCE ,Pass,65,19,84,J2EE ,Pass,49,20,69,J2EE AND SOFTWARE TESTING LABORATORY,Pass,75,20,95,PROJECT AND VIVA VOCE ,Pass,225,60,285
M1613613, College : 5207  -  SECAB INSTITUTE OF BUSINESS ADMINISTRATION  VIJAYAPURA,DISTI,81.46,SOFTWARE PRACTICES AND TESTING ,Pass,48,19,67,BUSINESS INTELLIGENCE ,Pass,72,12,84,J2EE ,Pass,42,19,61,J2EE AND SOFTWARE TESTING LABORATORY,Pass,72,20,92,PROJECT AND VIVA VOCE ,Pass,216,60,276
M1613615, College : 5207  -  SECAB INSTITUTE OF BUSINESS ADMINISTRATION  VIJAYAPURA,1ST C,69.14,SOFTWARE PRACTICES AND TESTING ,Pass,47,17,64,BUSINESS INTELLIGENCE ,Pass,64,11,75,J2EE ,Pass,36,18,54,J2EE AND SOFTWARE TESTING LABORATORY,Pass,58,17,75,PROJECT AND VIVA VOCE ,Pass,172,52,224
M1613616, College : 5207  -  SECAB INSTITUTE OF BUSINESS ADMINISTRATION  VIJAYAPURA,1ST C,65.11,SOFTWARE PRACTICES AND TESTING ,Pass,32,18,50,BUSINESS INTELLIGENCE ,Pass,50,13,63,J2EE ,Pass,32,18,50,J2EE AND SOFTWARE TESTING LABORATORY,Pass,62,17,79,PROJECT AND VIVA VOCE ,Pass,178,52,230
M1613617, College : 5207  -  SECAB INSTITUTE OF BUSINESS ADMINISTRATION  VIJAYAPURA,FAIL,64.86,SOFTWARE PRACTICES AND TESTING ,Pass,32,16,48,BUSINESS INTELLIGENCE ,Pass,42,11,53,J2EE ,Fail,19,14,33,J2EE AND SOFTWARE TESTING LABORATORY,Pass,62,13,75,PROJECT AND VIVA VOCE ,Pass,200,45,245
M1613618, College : 5207  -  SECAB INSTITUTE OF BUSINESS ADMINISTRATION  VIJAYAPURA,DISTI,70.38,SOFTWARE PRACTICES AND TESTING ,Pass,40,18,58,BUSINESS INTELLIGENCE ,Pass,63,11,74,J2EE ,Pass,38,16,54,J2EE AND SOFTWARE TESTING LABORATORY,Pass,62,15,77,PROJECT AND VIVA VOCE ,Pass,200,50,250
M1613619, College : 5207  -  SECAB INSTITUTE OF BUSINESS ADMINISTRATION  VIJAYAPURA,1ST C,62.95,SOFTWARE PRACTICES AND TESTING ,Pass,32,12,44,BUSINESS INTELLIGENCE ,Pass,39,11,50,J2EE ,Pass,32,14,46,J2EE AND SOFTWARE TESTING LABORATORY,Pass,57,13,70,PROJECT AND VIVA VOCE ,Pass,201,45,246
M1613621, College : 5207  -  SECAB INSTITUTE OF BUSINESS ADMINISTRATION  VIJAYAPURA,DISTI,86.68,SOFTWARE PRACTICES AND TESTING ,Pass,57,20,77,BUSINESS INTELLIGENCE ,Pass,70,19,89,J2EE ,Pass,47,20,67,J2EE AND SOFTWARE TESTING LABORATORY,Pass,72,20,92,PROJECT AND VIVA VOCE ,Pass,220,60,280
M1613622, College : 5207  -  SECAB INSTITUTE OF BUSINESS ADMINISTRATION  VIJAYAPURA,DISTI,81.92,SOFTWARE PRACTICES AND TESTING ,Pass,45,20,65,BUSINESS INTELLIGENCE ,Pass,63,19,82,J2EE ,Pass,43,20,63,J2EE AND SOFTWARE TESTING LABORATORY,Pass,70,20,90,PROJECT AND VIVA VOCE ,Pass,210,58,268
M1613623, College : 5207  -  SECAB INSTITUTE OF BUSINESS ADMINISTRATION  VIJAYAPURA,DISTI,84.54,SOFTWARE PRACTICES AND TESTING ,Pass,42,20,62,BUSINESS INTELLIGENCE ,Pass,62,19,81,J2EE ,Pass,47,20,67,J2EE AND SOFTWARE TESTING LABORATORY,Pass,76,20,96,PROJECT AND VIVA VOCE ,Pass,221,60,281
M1613624, College : 5207  -  SECAB INSTITUTE OF BUSINESS ADMINISTRATION  VIJAYAPURA,1ST C,63.27,SOFTWARE PRACTICES AND TESTING ,Pass,32,16,48,BUSINESS INTELLIGENCE ,Pass,49,11,60,J2EE ,Pass,32,16,48,J2EE AND SOFTWARE TESTING LABORATORY,Pass,60,13,73,PROJECT AND VIVA VOCE ,Pass,184,45,229
M1613625, College : 5207  -  SECAB INSTITUTE OF BUSINESS ADMINISTRATION  VIJAYAPURA,DISTI,72,SOFTWARE PRACTICES AND TESTING ,Pass,35,20,55,BUSINESS INTELLIGENCE ,Pass,52,18,70,J2EE ,Pass,42,18,60,J2EE AND SOFTWARE TESTING LABORATORY,Pass,64,17,81,PROJECT AND VIVA VOCE ,Pass,200,58,258
M1613626, College : 5207  -  SECAB INSTITUTE OF BUSINESS ADMINISTRATION  VIJAYAPURA,DISTI,83.3,SOFTWARE PRACTICES AND TESTING ,Pass,42,20,62,BUSINESS INTELLIGENCE ,Pass,69,19,88,J2EE ,Pass,46,20,66,J2EE AND SOFTWARE TESTING LABORATORY,Pass,68,20,88,PROJECT AND VIVA VOCE ,Pass,221,60,281
M1613628, College : 5207  -  SECAB INSTITUTE OF BUSINESS ADMINISTRATION  VIJAYAPURA,DISTI,75.97,SOFTWARE PRACTICES AND TESTING ,Pass,40,20,60,BUSINESS INTELLIGENCE ,Pass,60,17,77,J2EE ,Pass,44,14,58,J2EE AND SOFTWARE TESTING LABORATORY,Pass,60,17,77,PROJECT AND VIVA VOCE ,Pass,198,52,250
M1613629, College : 5207  -  SECAB INSTITUTE OF BUSINESS ADMINISTRATION  VIJAYAPURA,DISTI,78.16,SOFTWARE PRACTICES AND TESTING ,Pass,38,20,58,BUSINESS INTELLIGENCE ,Pass,70,20,90,J2EE ,Pass,43,20,63,J2EE AND SOFTWARE TESTING LABORATORY,Pass,72,19,91,PROJECT AND VIVA VOCE ,Pass,210,56,266
M1613630, College : 5207  -  SECAB INSTITUTE OF BUSINESS ADMINISTRATION  VIJAYAPURA,DISTI,76.51,SOFTWARE PRACTICES AND TESTING ,Pass,42,20,62,BUSINESS INTELLIGENCE ,Pass,76,19,95,J2EE ,Pass,43,19,62,J2EE AND SOFTWARE TESTING LABORATORY,Pass,64,19,83,PROJECT AND VIVA VOCE ,Pass,200,56,256
M1613631, College : 5207  -  SECAB INSTITUTE OF BUSINESS ADMINISTRATION  VIJAYAPURA,DISTI,71.89,SOFTWARE PRACTICES AND TESTING ,Pass,41,18,59,BUSINESS INTELLIGENCE ,Pass,45,16,61,J2EE ,Pass,32,16,48,J2EE AND SOFTWARE TESTING LABORATORY,Pass,60,18,78,PROJECT AND VIVA VOCE ,Pass,200,54,254
M1613632, College : 5207  -  SECAB INSTITUTE OF BUSINESS ADMINISTRATION  VIJAYAPURA,DISTI,87.32,SOFTWARE PRACTICES AND TESTING ,Pass,49,20,69,BUSINESS INTELLIGENCE ,Pass,68,20,88,J2EE ,Pass,39,20,59,J2EE AND SOFTWARE TESTING LABORATORY,Pass,76,20,96,PROJECT AND VIVA VOCE ,Pass,220,60,280
M1613633, College : 5207  -  SECAB INSTITUTE OF BUSINESS ADMINISTRATION  VIJAYAPURA,FAIL,62.57,SOFTWARE PRACTICES AND TESTING ,Fail,14,18,32,BUSINESS INTELLIGENCE ,Pass,42,11,53,J2EE ,Pass,52,18,70,J2EE AND SOFTWARE TESTING LABORATORY,Pass,64,15,79,PROJECT AND VIVA VOCE ,Pass,152,52,204
M1613634, College : 5207  -  SECAB INSTITUTE OF BUSINESS ADMINISTRATION  VIJAYAPURA,DISTI,79.11,SOFTWARE PRACTICES AND TESTING ,Pass,35,20,55,BUSINESS INTELLIGENCE ,Pass,53,17,70,J2EE ,Pass,64,18,82,J2EE AND SOFTWARE TESTING LABORATORY,Pass,70,18,88,PROJECT AND VIVA VOCE ,Pass,200,56,256
M1613635, College : 5207  -  SECAB INSTITUTE OF BUSINESS ADMINISTRATION  VIJAYAPURA,DISTI,81.84,SOFTWARE PRACTICES AND TESTING ,Pass,48,20,68,BUSINESS INTELLIGENCE ,Pass,61,19,80,J2EE ,Pass,70,19,89,J2EE AND SOFTWARE TESTING LABORATORY,Pass,68,19,87,PROJECT AND VIVA VOCE ,Pass,210,58,268
M1613638, College : 5207  -  SECAB INSTITUTE OF BUSINESS ADMINISTRATION  VIJAYAPURA,DISTI,87.89,SOFTWARE PRACTICES AND TESTING ,Pass,58,20,78,BUSINESS INTELLIGENCE ,Pass,61,19,80,J2EE ,Pass,73,20,93,J2EE AND SOFTWARE TESTING LABORATORY,Pass,74,20,94,PROJECT AND VIVA VOCE ,Pass,220,60,280
M1613640, College : 5207  -  SECAB INSTITUTE OF BUSINESS ADMINISTRATION  VIJAYAPURA,DISTI,79.76,SOFTWARE PRACTICES AND TESTING ,Pass,55,19,74,BUSINESS INTELLIGENCE ,Pass,59,19,78,J2EE ,Pass,71,20,91,J2EE AND SOFTWARE TESTING LABORATORY,Pass,70,20,90,PROJECT AND VIVA VOCE ,Pass,210,58,268
M1613802, College : 5212  -  V V S S ARTS & COMMERCE COLLEGE  VIJAYAPURA,N.C.L,--   ,SOFTWARE PRACTICES AND TESTING ,Pass,61,19,80,BUSINESS INTELLIGENCE ,Pass,54,20,74,J2EE ,Pass,32,16,48,J2EE AND SOFTWARE TESTING LABORATORY,Pass,73,16,89,PROJECT AND VIVA VOCE ,Pass,190,53,243
M1613804, College : 5212  -  V V S S ARTS & COMMERCE COLLEGE  VIJAYAPURA,DISTI,73.05,SOFTWARE PRACTICES AND TESTING ,Pass,66,19,85,BUSINESS INTELLIGENCE ,Pass,70,16,86,J2EE ,Pass,32,15,47,J2EE AND SOFTWARE TESTING LABORATORY,Pass,67,17,84,PROJECT AND VIVA VOCE ,Pass,220,50,270
M1613806, College : 5212  -  V V S S ARTS & COMMERCE COLLEGE  VIJAYAPURA,FAIL,68.14,SOFTWARE PRACTICES AND TESTING ,Pass,44,20,64,BUSINESS INTELLIGENCE ,Pass,58,19,77,J2EE ,Fail,22,17,39,J2EE AND SOFTWARE TESTING LABORATORY,Pass,51,15,66,PROJECT AND VIVA VOCE ,Pass,180,51,231
M1613807, College : 5212  -  V V S S ARTS & COMMERCE COLLEGE  VIJAYAPURA,N.C.L,--   ,SOFTWARE PRACTICES AND TESTING ,Pass,40,19,59,BUSINESS INTELLIGENCE ,Pass,55,19,74,J2EE ,Pass,49,19,68,J2EE AND SOFTWARE TESTING LABORATORY,Pass,65,19,84,PROJECT AND VIVA VOCE ,Pass,227,58,285
M1613808, College : 5212  -  V V S S ARTS & COMMERCE COLLEGE  VIJAYAPURA,FAIL,62.57,SOFTWARE PRACTICES AND TESTING ,Pass,34,14,48,BUSINESS INTELLIGENCE ,Pass,45,18,63,J2EE ,Fail,18,15,33,J2EE AND SOFTWARE TESTING LABORATORY,Pass,49,15,64,PROJECT AND VIVA VOCE ,Pass,180,50,230
M1613809, College : 5212  -  V V S S ARTS & COMMERCE COLLEGE  VIJAYAPURA,DISTI,81.46,SOFTWARE PRACTICES AND TESTING ,Pass,65,20,85,BUSINESS INTELLIGENCE ,Pass,72,20,92,J2EE ,Pass,37,18,55,J2EE AND SOFTWARE TESTING LABORATORY,Pass,77,16,93,PROJECT AND VIVA VOCE ,Pass,200,50,250
M1613810, College : 5212  -  V V S S ARTS & COMMERCE COLLEGE  VIJAYAPURA,DISTI,89,SOFTWARE PRACTICES AND TESTING ,Pass,69,19,88,BUSINESS INTELLIGENCE ,Pass,68,18,86,J2EE ,Pass,59,17,76,J2EE AND SOFTWARE TESTING LABORATORY,Pass,78,19,97,PROJECT AND VIVA VOCE ,Pass,225,50,275
M1613811, College : 5212  -  V V S S ARTS & COMMERCE COLLEGE  VIJAYAPURA,N.C.L,--   ,SOFTWARE PRACTICES AND TESTING ,Pass,49,18,67,BUSINESS INTELLIGENCE ,Pass,58,16,74,J2EE ,Pass,35,14,49,J2EE AND SOFTWARE TESTING LABORATORY,Pass,75,12,87,PROJECT AND VIVA VOCE ,Pass,230,56,286
M1613812, College : 5212  -  V V S S ARTS & COMMERCE COLLEGE  VIJAYAPURA,DISTI,84.27,SOFTWARE PRACTICES AND TESTING ,Pass,63,19,82,BUSINESS INTELLIGENCE ,Pass,66,20,86,J2EE ,Pass,51,19,70,J2EE AND SOFTWARE TESTING LABORATORY,Pass,77,16,93,PROJECT AND VIVA VOCE ,Pass,230,58,288
M1613813, College : 5212  -  V V S S ARTS & COMMERCE COLLEGE  VIJAYAPURA,DISTI,70.51,SOFTWARE PRACTICES AND TESTING ,Pass,46,14,60,BUSINESS INTELLIGENCE ,Pass,64,14,78,J2EE ,Pass,48,13,61,J2EE AND SOFTWARE TESTING LABORATORY,Pass,52,12,64,PROJECT AND VIVA VOCE ,Pass,160,50,210
M1613814, College : 5212  -  V V S S ARTS & COMMERCE COLLEGE  VIJAYAPURA,DISTI,84.62,SOFTWARE PRACTICES AND TESTING ,Pass,62,19,81,BUSINESS INTELLIGENCE ,Pass,72,19,91,J2EE ,Pass,32,18,50,J2EE AND SOFTWARE TESTING LABORATORY,Pass,77,18,95,PROJECT AND VIVA VOCE ,Pass,230,58,288
M1613815, College : 5212  -  V V S S ARTS & COMMERCE COLLEGE  VIJAYAPURA,FAIL,71.43,SOFTWARE PRACTICES AND TESTING ,Pass,50,20,70,BUSINESS INTELLIGENCE ,Pass,50,17,67,J2EE ,Fail,14,15,29,J2EE AND SOFTWARE TESTING LABORATORY,Pass,71,18,89,PROJECT AND VIVA VOCE ,Pass,190,55,245
M1613818, College : 5212  -  V V S S ARTS & COMMERCE COLLEGE  VIJAYAPURA,DISTI,81.59,SOFTWARE PRACTICES AND TESTING ,Pass,60,20,80,BUSINESS INTELLIGENCE ,Pass,52,20,72,J2EE ,Pass,32,16,48,J2EE AND SOFTWARE TESTING LABORATORY,Pass,75,15,90,PROJECT AND VIVA VOCE ,Pass,225,58,283
M1613819, College : 5212  -  V V S S ARTS & COMMERCE COLLEGE  VIJAYAPURA,FAIL,58.71,SOFTWARE PRACTICES AND TESTING ,Pass,39,17,56,BUSINESS INTELLIGENCE ,Pass,56,14,70,J2EE ,Fail,11,14,25,J2EE AND SOFTWARE TESTING LABORATORY,Pass,45,10,55,PROJECT AND VIVA VOCE ,Pass,160,45,205
M1613820, College : 5212  -  V V S S ARTS & COMMERCE COLLEGE  VIJAYAPURA,DISTI,73.95,SOFTWARE PRACTICES AND TESTING ,Pass,61,19,80,BUSINESS INTELLIGENCE ,Pass,60,20,80,J2EE ,Pass,32,19,51,J2EE AND SOFTWARE TESTING LABORATORY,Pass,72,16,88,PROJECT AND VIVA VOCE ,Pass,195,51,246
M1613821, College : 5212  -  V V S S ARTS & COMMERCE COLLEGE  VIJAYAPURA,DISTI,79.11,SOFTWARE PRACTICES AND TESTING ,Pass,55,14,69,BUSINESS INTELLIGENCE ,Pass,59,15,74,J2EE ,Pass,42,13,55,J2EE AND SOFTWARE TESTING LABORATORY,Pass,72,13,85,PROJECT AND VIVA VOCE ,Pass,200,50,250
M1613822, College : 5212  -  V V S S ARTS & COMMERCE COLLEGE  VIJAYAPURA,FAIL,56.14,SOFTWARE PRACTICES AND TESTING ,Pass,33,13,46,BUSINESS INTELLIGENCE ,Pass,32,15,47,J2EE ,Fail,7,14,21,J2EE AND SOFTWARE TESTING LABORATORY,Pass,40,13,53,PROJECT AND VIVA VOCE ,Pass,180,46,226
M1613823, College : 5212  -  V V S S ARTS & COMMERCE COLLEGE  VIJAYAPURA,FAIL,49.43,SOFTWARE PRACTICES AND TESTING ,Pass,32,12,44,BUSINESS INTELLIGENCE ,Pass,32,15,47,J2EE ,Fail,4,11,15,J2EE AND SOFTWARE TESTING LABORATORY,Pass,45,10,55,PROJECT AND VIVA VOCE ,Pass,145,40,185
M1613824, College : 5212  -  V V S S ARTS & COMMERCE COLLEGE  VIJAYAPURA,DISTI,78.41,SOFTWARE PRACTICES AND TESTING ,Pass,65,19,84,BUSINESS INTELLIGENCE ,Pass,68,20,88,J2EE ,Pass,33,19,52,J2EE AND SOFTWARE TESTING LABORATORY,Pass,75,17,92,PROJECT AND VIVA VOCE ,Pass,230,58,288
M1613825, College : 5212  -  V V S S ARTS & COMMERCE COLLEGE  VIJAYAPURA,FAIL,61,SOFTWARE PRACTICES AND TESTING ,Pass,42,15,57,BUSINESS INTELLIGENCE ,Pass,46,14,60,J2EE ,Fail,15,13,28,J2EE AND SOFTWARE TESTING LABORATORY,Pass,50,12,62,PROJECT AND VIVA VOCE ,Pass,170,50,220
M1613826, College : 5212  -  V V S S ARTS & COMMERCE COLLEGE  VIJAYAPURA,N.C.L,--   ,SOFTWARE PRACTICES AND TESTING ,Pass,39,19,58,BUSINESS INTELLIGENCE ,Pass,52,19,71,J2EE ,Pass,53,19,72,J2EE AND SOFTWARE TESTING LABORATORY,Pass,69,19,88,PROJECT AND VIVA VOCE ,Pass,229,58,287
M1613827, College : 5212  -  V V S S ARTS & COMMERCE COLLEGE  VIJAYAPURA,FAIL,54.57,SOFTWARE PRACTICES AND TESTING ,Pass,32,13,45,BUSINESS INTELLIGENCE ,Fail,19,15,34,J2EE ,Fail,9,12,21,J2EE AND SOFTWARE TESTING LABORATORY,Pass,60,14,74,PROJECT AND VIVA VOCE ,Pass,160,48,208
M1613828, College : 5212  -  V V S S ARTS & COMMERCE COLLEGE  VIJAYAPURA,FAIL,62.86,SOFTWARE PRACTICES AND TESTING ,Pass,32,15,47,BUSINESS INTELLIGENCE ,Pass,37,15,52,J2EE ,Fail,10,13,23,J2EE AND SOFTWARE TESTING LABORATORY,Pass,52,16,68,PROJECT AND VIVA VOCE ,Pass,200,50,250
M1613829, College : 5212  -  V V S S ARTS & COMMERCE COLLEGE  VIJAYAPURA,FAIL,63.14,SOFTWARE PRACTICES AND TESTING ,Pass,36,13,49,BUSINESS INTELLIGENCE ,Pass,33,12,45,J2EE ,Fail,16,14,30,J2EE AND SOFTWARE TESTING LABORATORY,Pass,72,16,88,PROJECT AND VIVA VOCE ,Pass,180,50,230
M1613830, College : 5212  -  V V S S ARTS & COMMERCE COLLEGE  VIJAYAPURA,FAIL,42.71,SOFTWARE PRACTICES AND TESTING ,Fail,15,8,23,BUSINESS INTELLIGENCE ,Pass,32,8,40,J2EE ,Fail,10,8,18,J2EE AND SOFTWARE TESTING LABORATORY,Pass,35,8,43,PROJECT AND VIVA VOCE ,Pass,140,35,175
M1613831, College : 5212  -  V V S S ARTS & COMMERCE COLLEGE  VIJAYAPURA,FAIL,62.57,SOFTWARE PRACTICES AND TESTING ,Pass,40,14,54,BUSINESS INTELLIGENCE ,Pass,32,15,47,J2EE ,Fail,9,13,22,J2EE AND SOFTWARE TESTING LABORATORY,Pass,66,15,81,PROJECT AND VIVA VOCE ,Pass,185,49,234
M1613832, College : 5212  -  V V S S ARTS & COMMERCE COLLEGE  VIJAYAPURA,FAIL,61.29,SOFTWARE PRACTICES AND TESTING ,Pass,47,13,60,BUSINESS INTELLIGENCE ,Pass,32,14,46,J2EE ,Fail,9,13,22,J2EE AND SOFTWARE TESTING LABORATORY,Pass,55,15,70,PROJECT AND VIVA VOCE ,Pass,182,49,231
M1613833, College : 5212  -  V V S S ARTS & COMMERCE COLLEGE  VIJAYAPURA,FAIL,57.86,SOFTWARE PRACTICES AND TESTING ,Pass,32,13,45,BUSINESS INTELLIGENCE ,Pass,32,14,46,J2EE ,Fail,14,13,27,J2EE AND SOFTWARE TESTING LABORATORY,Pass,57,16,73,PROJECT AND VIVA VOCE ,Pass,165,49,214
M1613834, College : 5212  -  V V S S ARTS & COMMERCE COLLEGE  VIJAYAPURA,FAIL,82.86,SOFTWARE PRACTICES AND TESTING ,Pass,59,19,78,BUSINESS INTELLIGENCE ,Pass,53,20,73,J2EE ,Fail,22,19,41,J2EE AND SOFTWARE TESTING LABORATORY,Pass,76,19,95,PROJECT AND VIVA VOCE ,Pass,235,58,293
M1613835, College : 5212  -  V V S S ARTS & COMMERCE COLLEGE  VIJAYAPURA,FAIL,63.71,SOFTWARE PRACTICES AND TESTING ,Pass,41,16,57,BUSINESS INTELLIGENCE ,Pass,44,15,59,J2EE ,Fail,22,13,35,J2EE AND SOFTWARE TESTING LABORATORY,Pass,65,16,81,PROJECT AND VIVA VOCE ,Pass,165,49,214
M1613836, College : 5212  -  V V S S ARTS & COMMERCE COLLEGE  VIJAYAPURA,DISTI,84.14,SOFTWARE PRACTICES AND TESTING ,Pass,52,19,71,BUSINESS INTELLIGENCE ,Pass,53,19,72,J2EE ,Pass,35,18,53,J2EE AND SOFTWARE TESTING LABORATORY,Pass,78,19,97,PROJECT AND VIVA VOCE ,Pass,235,58,293
M1613837, College : 5212  -  V V S S ARTS & COMMERCE COLLEGE  VIJAYAPURA,FAIL,65.43,SOFTWARE PRACTICES AND TESTING ,Pass,45,18,63,BUSINESS INTELLIGENCE ,Pass,40,18,58,J2EE ,Fail,22,16,38,J2EE AND SOFTWARE TESTING LABORATORY,Pass,72,18,90,PROJECT AND VIVA VOCE ,Pass,160,49,209
M1613839, College : 5212  -  V V S S ARTS & COMMERCE COLLEGE  VIJAYAPURA,FAIL,54.29,SOFTWARE PRACTICES AND TESTING ,Pass,37,14,51,BUSINESS INTELLIGENCE ,Pass,35,14,49,J2EE ,Fail,18,13,31,J2EE AND SOFTWARE TESTING LABORATORY,Pass,41,14,55,PROJECT AND VIVA VOCE ,Pass,150,44,194
M1613840, College : 5212  -  V V S S ARTS & COMMERCE COLLEGE  VIJAYAPURA,FAIL,59,SOFTWARE PRACTICES AND TESTING ,Pass,37,16,53,BUSINESS INTELLIGENCE ,Pass,32,16,48,J2EE ,Fail,10,13,23,J2EE AND SOFTWARE TESTING LABORATORY,Pass,45,17,62,PROJECT AND VIVA VOCE ,Pass,180,47,227
M1613841, College : 5212  -  V V S S ARTS & COMMERCE COLLEGE  VIJAYAPURA,FAIL,57.86,SOFTWARE PRACTICES AND TESTING ,Pass,36,15,51,BUSINESS INTELLIGENCE ,Pass,32,13,45,J2EE ,Fail,15,13,28,J2EE AND SOFTWARE TESTING LABORATORY,Pass,46,12,58,PROJECT AND VIVA VOCE ,Pass,175,48,223
M1613842, College : 5212  -  V V S S ARTS & COMMERCE COLLEGE  VIJAYAPURA,FAIL,63.29,SOFTWARE PRACTICES AND TESTING ,Pass,51,17,68,BUSINESS INTELLIGENCE ,Fail,17,15,32,J2EE ,Fail,11,14,25,J2EE AND SOFTWARE TESTING LABORATORY,Pass,66,15,81,PROJECT AND VIVA VOCE ,Pass,182,55,237
M1613843, College : 5212  -  V V S S ARTS & COMMERCE COLLEGE  VIJAYAPURA,DISTI,86.59,SOFTWARE PRACTICES AND TESTING ,Pass,61,20,81,BUSINESS INTELLIGENCE ,Pass,44,20,64,J2EE ,Pass,39,18,57,J2EE AND SOFTWARE TESTING LABORATORY,Pass,80,18,98,PROJECT AND VIVA VOCE ,Pass,222,55,277
M1613844, College : 5212  -  V V S S ARTS & COMMERCE COLLEGE  VIJAYAPURA,DISTI,78,SOFTWARE PRACTICES AND TESTING ,Pass,63,20,83,BUSINESS INTELLIGENCE ,Pass,37,20,57,J2EE ,Pass,34,18,52,J2EE AND SOFTWARE TESTING LABORATORY,Pass,79,18,97,PROJECT AND VIVA VOCE ,Pass,195,57,252
M1613845, College : 5212  -  V V S S ARTS & COMMERCE COLLEGE  VIJAYAPURA,DISTI,77.24,SOFTWARE PRACTICES AND TESTING ,Pass,52,19,71,BUSINESS INTELLIGENCE ,Pass,35,18,53,J2EE ,Pass,32,17,49,J2EE AND SOFTWARE TESTING LABORATORY,Pass,78,18,96,PROJECT AND VIVA VOCE ,Pass,190,50,240
M1613846, College : 5212  -  V V S S ARTS & COMMERCE COLLEGE  VIJAYAPURA,N.C.L,--   ,SOFTWARE PRACTICES AND TESTING ,Pass,44,17,61,BUSINESS INTELLIGENCE ,Pass,40,16,56,J2EE ,Pass,32,15,47,J2EE AND SOFTWARE TESTING LABORATORY,Pass,63,15,78,PROJECT AND VIVA VOCE ,Pass,195,49,244
M1613847, College : 5212  -  V V S S ARTS & COMMERCE COLLEGE  VIJAYAPURA,FAIL,66.43,SOFTWARE PRACTICES AND TESTING ,Pass,46,19,65,BUSINESS INTELLIGENCE ,Pass,37,20,57,J2EE ,Fail,17,15,32,J2EE AND SOFTWARE TESTING LABORATORY,Pass,67,15,82,PROJECT AND VIVA VOCE ,Pass,180,49,229
M1613848, College : 5212  -  V V S S ARTS & COMMERCE COLLEGE  VIJAYAPURA,FAIL,61.43,SOFTWARE PRACTICES AND TESTING ,Pass,36,17,53,BUSINESS INTELLIGENCE ,Pass,34,14,48,J2EE ,Fail,17,13,30,J2EE AND SOFTWARE TESTING LABORATORY,Pass,64,15,79,PROJECT AND VIVA VOCE ,Pass,170,50,220
M1613849, College : 5212  -  V V S S ARTS & COMMERCE COLLEGE  VIJAYAPURA,FAIL,57.43,SOFTWARE PRACTICES AND TESTING ,Pass,36,13,49,BUSINESS INTELLIGENCE ,Pass,35,12,47,J2EE ,Fail,13,14,27,J2EE AND SOFTWARE TESTING LABORATORY,Pass,57,12,69,PROJECT AND VIVA VOCE ,Pass,160,50,210
M1613850, College : 5212  -  V V S S ARTS & COMMERCE COLLEGE  VIJAYAPURA,FAIL,53.43,SOFTWARE PRACTICES AND TESTING ,Pass,38,13,51,BUSINESS INTELLIGENCE ,Pass,43,15,58,J2EE ,Fail,16,12,28,J2EE AND SOFTWARE TESTING LABORATORY,Pass,41,11,52,PROJECT AND VIVA VOCE ,Pass,140,45,185
M1614002, College : 5217  -  KUMUD BEN DARBAR COLLEGE OF B.C.A.  VIJAYAPURA,DISTI,77.86,SOFTWARE PRACTICES AND TESTING ,Pass,57,16,73,BUSINESS INTELLIGENCE ,Pass,55,15,70,J2EE ,Pass,45,17,62,J2EE AND SOFTWARE TESTING LABORATORY,Pass,77,20,97,PROJECT AND VIVA VOCE ,Pass,210,60,270
M1614003, College : 5217  -  KUMUD BEN DARBAR COLLEGE OF B.C.A.  VIJAYAPURA,DISTI,70.08,SOFTWARE PRACTICES AND TESTING ,Pass,49,14,63,BUSINESS INTELLIGENCE ,Pass,41,8,49,J2EE ,Pass,51,12,63,J2EE AND SOFTWARE TESTING LABORATORY,Pass,71,18,89,PROJECT AND VIVA VOCE ,Pass,200,58,258
M1614004, College : 5217  -  KUMUD BEN DARBAR COLLEGE OF B.C.A.  VIJAYAPURA,DISTI,75.08,SOFTWARE PRACTICES AND TESTING ,Pass,48,15,63,BUSINESS INTELLIGENCE ,Pass,52,16,68,J2EE ,Pass,50,16,66,J2EE AND SOFTWARE TESTING LABORATORY,Pass,75,20,95,PROJECT AND VIVA VOCE ,Pass,210,60,270
M1614005, College : 5217  -  KUMUD BEN DARBAR COLLEGE OF B.C.A.  VIJAYAPURA,N.C.L,--   ,SOFTWARE PRACTICES AND TESTING ,Pass,39,9,48,BUSINESS INTELLIGENCE ,Pass,39,9,48,J2EE ,Pass,38,12,50,J2EE AND SOFTWARE TESTING LABORATORY,Pass,71,19,90,PROJECT AND VIVA VOCE ,Pass,180,60,240
M1614006, College : 5217  -  KUMUD BEN DARBAR COLLEGE OF B.C.A.  VIJAYAPURA,N.C.L,--   ,SOFTWARE PRACTICES AND TESTING ,Pass,32,9,41,BUSINESS INTELLIGENCE ,Pass,33,8,41,J2EE ,Pass,35,11,46,J2EE AND SOFTWARE TESTING LABORATORY,Pass,73,18,91,PROJECT AND VIVA VOCE ,Pass,200,59,259
M1614007, College : 5217  -  KUMUD BEN DARBAR COLLEGE OF B.C.A.  VIJAYAPURA,N.C.L,--   ,SOFTWARE PRACTICES AND TESTING ,Pass,33,9,42,BUSINESS INTELLIGENCE ,Pass,34,8,42,J2EE ,Pass,32,8,40,J2EE AND SOFTWARE TESTING LABORATORY,Pass,70,16,86,PROJECT AND VIVA VOCE ,Pass,210,55,265
M1614008, College : 5217  -  KUMUD BEN DARBAR COLLEGE OF B.C.A.  VIJAYAPURA,1ST C,68.65,SOFTWARE PRACTICES AND TESTING ,Pass,39,15,54,BUSINESS INTELLIGENCE ,Pass,40,9,49,J2EE ,Pass,45,10,55,J2EE AND SOFTWARE TESTING LABORATORY,Pass,75,18,93,PROJECT AND VIVA VOCE ,Pass,200,58,258
M1614009, College : 5217  -  KUMUD BEN DARBAR COLLEGE OF B.C.A.  VIJAYAPURA,DISTI,83.68,SOFTWARE PRACTICES AND TESTING ,Pass,43,16,59,BUSINESS INTELLIGENCE ,Pass,50,13,63,J2EE ,Pass,66,15,81,J2EE AND SOFTWARE TESTING LABORATORY,Pass,79,20,99,PROJECT AND VIVA VOCE ,Pass,240,60,300
M1614011, College : 5217  -  KUMUD BEN DARBAR COLLEGE OF B.C.A.  VIJAYAPURA,DISTI,86.54,SOFTWARE PRACTICES AND TESTING ,Pass,52,18,70,BUSINESS INTELLIGENCE ,Pass,66,16,82,J2EE ,Pass,49,16,65,J2EE AND SOFTWARE TESTING LABORATORY,Pass,80,20,100,PROJECT AND VIVA VOCE ,Pass,210,60,270
M1614012, College : 5217  -  KUMUD BEN DARBAR COLLEGE OF B.C.A.  VIJAYAPURA,1ST C,68.54,SOFTWARE PRACTICES AND TESTING ,Pass,54,15,69,BUSINESS INTELLIGENCE ,Pass,47,14,61,J2EE ,Pass,48,15,63,J2EE AND SOFTWARE TESTING LABORATORY,Pass,76,19,95,PROJECT AND VIVA VOCE ,Pass,210,59,269
M1614013, College : 5217  -  KUMUD BEN DARBAR COLLEGE OF B.C.A.  VIJAYAPURA,1ST C,68.54,SOFTWARE PRACTICES AND TESTING ,Pass,49,14,63,BUSINESS INTELLIGENCE ,Pass,54,13,67,J2EE ,Pass,45,15,60,J2EE AND SOFTWARE TESTING LABORATORY,Pass,78,20,98,PROJECT AND VIVA VOCE ,Pass,200,60,260
M1614015, College : 5217  -  KUMUD BEN DARBAR COLLEGE OF B.C.A.  VIJAYAPURA,N.C.L,--   ,SOFTWARE PRACTICES AND TESTING ,Pass,43,16,59,BUSINESS INTELLIGENCE ,Pass,35,14,49,J2EE ,Pass,33,19,52,J2EE AND SOFTWARE TESTING LABORATORY,Pass,70,16,86,PROJECT AND VIVA VOCE ,Pass,230,56,286
M1614017, College : 5217  -  KUMUD BEN DARBAR COLLEGE OF B.C.A.  VIJAYAPURA,1ST C,69.08,SOFTWARE PRACTICES AND TESTING ,Pass,43,13,56,BUSINESS INTELLIGENCE ,Pass,44,13,57,J2EE ,Pass,56,13,69,J2EE AND SOFTWARE TESTING LABORATORY,Pass,78,20,98,PROJECT AND VIVA VOCE ,Pass,190,60,250
M1614019, College : 5217  -  KUMUD BEN DARBAR COLLEGE OF B.C.A.  VIJAYAPURA,1ST C,67,SOFTWARE PRACTICES AND TESTING ,Pass,36,15,51,BUSINESS INTELLIGENCE ,Pass,42,13,55,J2EE ,Pass,40,16,56,J2EE AND SOFTWARE TESTING LABORATORY,Pass,72,19,91,PROJECT AND VIVA VOCE ,Pass,210,60,270
M1614020, College : 5217  -  KUMUD BEN DARBAR COLLEGE OF B.C.A.  VIJAYAPURA,N.C.L,--   ,SOFTWARE PRACTICES AND TESTING ,Pass,36,9,45,BUSINESS INTELLIGENCE ,Pass,45,8,53,J2EE ,Pass,32,10,42,J2EE AND SOFTWARE TESTING LABORATORY,Pass,75,18,93,PROJECT AND VIVA VOCE ,Pass,200,59,259
M1614021, College : 5217  -  KUMUD BEN DARBAR COLLEGE OF B.C.A.  VIJAYAPURA,DISTI,72.78,SOFTWARE PRACTICES AND TESTING ,Pass,43,15,58,BUSINESS INTELLIGENCE ,Pass,41,16,57,J2EE ,Pass,60,12,72,J2EE AND SOFTWARE TESTING LABORATORY,Pass,72,19,91,PROJECT AND VIVA VOCE ,Pass,210,60,270
M1614022, College : 5217  -  KUMUD BEN DARBAR COLLEGE OF B.C.A.  VIJAYAPURA,N.C.L,--   ,SOFTWARE PRACTICES AND TESTING ,Pass,42,8,50,BUSINESS INTELLIGENCE ,Pass,32,8,40,J2EE ,Pass,55,10,65,J2EE AND SOFTWARE TESTING LABORATORY,Pass,71,20,91,PROJECT AND VIVA VOCE ,Pass,230,60,290
M1614023, College : 5217  -  KUMUD BEN DARBAR COLLEGE OF B.C.A.  VIJAYAPURA,DISTI,81.7,SOFTWARE PRACTICES AND TESTING ,Pass,64,18,82,BUSINESS INTELLIGENCE ,Pass,62,18,80,J2EE ,Pass,65,15,80,J2EE AND SOFTWARE TESTING LABORATORY,Pass,75,20,95,PROJECT AND VIVA VOCE ,Pass,210,60,270
M1614024, College : 5217  -  KUMUD BEN DARBAR COLLEGE OF B.C.A.  VIJAYAPURA,N.C.L,--   ,SOFTWARE PRACTICES AND TESTING ,Pass,34,15,49,BUSINESS INTELLIGENCE ,Pass,33,18,51,J2EE ,Pass,32,16,48,J2EE AND SOFTWARE TESTING LABORATORY,Pass,70,17,87,PROJECT AND VIVA VOCE ,Pass,232,57,289
M1614025, College : 5217  -  KUMUD BEN DARBAR COLLEGE OF B.C.A.  VIJAYAPURA,N.C.L,--   ,SOFTWARE PRACTICES AND TESTING ,Pass,50,15,65,BUSINESS INTELLIGENCE ,Pass,32,14,46,J2EE ,Pass,40,18,58,J2EE AND SOFTWARE TESTING LABORATORY,Pass,70,16,86,PROJECT AND VIVA VOCE ,Pass,231,55,286
M1614028, College : 5217  -  KUMUD BEN DARBAR COLLEGE OF B.C.A.  VIJAYAPURA,DISTI,77.73,SOFTWARE PRACTICES AND TESTING ,Pass,53,14,67,BUSINESS INTELLIGENCE ,Pass,56,14,70,J2EE ,Pass,66,16,82,J2EE AND SOFTWARE TESTING LABORATORY,Pass,78,20,98,PROJECT AND VIVA VOCE ,Pass,220,60,280
M1614029, College : 5217  -  KUMUD BEN DARBAR COLLEGE OF B.C.A.  VIJAYAPURA,N.C.L,--   ,SOFTWARE PRACTICES AND TESTING ,Pass,37,17,54,BUSINESS INTELLIGENCE ,Pass,36,14,50,J2EE ,Pass,38,18,56,J2EE AND SOFTWARE TESTING LABORATORY,Pass,68,17,85,PROJECT AND VIVA VOCE ,Pass,230,57,287
M1614030, College : 5217  -  KUMUD BEN DARBAR COLLEGE OF B.C.A.  VIJAYAPURA,N.C.L,--   ,SOFTWARE PRACTICES AND TESTING ,Pass,43,11,54,BUSINESS INTELLIGENCE ,Pass,43,9,52,J2EE ,Pass,54,8,62,J2EE AND SOFTWARE TESTING LABORATORY,Pass,71,18,89,PROJECT AND VIVA VOCE ,Pass,200,60,260
M1614031, College : 5217  -  KUMUD BEN DARBAR COLLEGE OF B.C.A.  VIJAYAPURA,DISTI,75.38,SOFTWARE PRACTICES AND TESTING ,Pass,48,14,62,BUSINESS INTELLIGENCE ,Pass,50,9,59,J2EE ,Pass,56,8,64,J2EE AND SOFTWARE TESTING LABORATORY,Pass,73,18,91,PROJECT AND VIVA VOCE ,Pass,190,58,248
M1614032, College : 5217  -  KUMUD BEN DARBAR COLLEGE OF B.C.A.  VIJAYAPURA,N.C.L,--   ,SOFTWARE PRACTICES AND TESTING ,Pass,41,8,49,BUSINESS INTELLIGENCE ,Pass,46,8,54,J2EE ,Pass,34,8,42,J2EE AND SOFTWARE TESTING LABORATORY,Pass,65,16,81,PROJECT AND VIVA VOCE ,Pass,210,50,260
M1614033, College : 5217  -  KUMUD BEN DARBAR COLLEGE OF B.C.A.  VIJAYAPURA,N.C.L,--   ,SOFTWARE PRACTICES AND TESTING ,Pass,37,8,45,BUSINESS INTELLIGENCE ,Pass,37,8,45,J2EE ,Pass,32,8,40,J2EE AND SOFTWARE TESTING LABORATORY,Pass,78,20,98,PROJECT AND VIVA VOCE ,Pass,220,60,280
M1614034, College : 5217  -  KUMUD BEN DARBAR COLLEGE OF B.C.A.  VIJAYAPURA,N.C.L,--   ,SOFTWARE PRACTICES AND TESTING ,Pass,43,16,59,BUSINESS INTELLIGENCE ,Pass,42,15,57,J2EE ,Pass,34,18,52,J2EE AND SOFTWARE TESTING LABORATORY,Pass,74,17,91,PROJECT AND VIVA VOCE ,Pass,234,56,290
M1614035, College : 5217  -  KUMUD BEN DARBAR COLLEGE OF B.C.A.  VIJAYAPURA,1ST C,66.68,SOFTWARE PRACTICES AND TESTING ,Pass,34,14,48,BUSINESS INTELLIGENCE ,Pass,43,10,53,J2EE ,Pass,37,14,51,J2EE AND SOFTWARE TESTING LABORATORY,Pass,77,20,97,PROJECT AND VIVA VOCE ,Pass,210,60,270
M1614036, College : 5217  -  KUMUD BEN DARBAR COLLEGE OF B.C.A.  VIJAYAPURA,DISTI,83.7,SOFTWARE PRACTICES AND TESTING ,Pass,64,14,78,BUSINESS INTELLIGENCE ,Pass,59,14,73,J2EE ,Pass,51,12,63,J2EE AND SOFTWARE TESTING LABORATORY,Pass,74,20,94,PROJECT AND VIVA VOCE ,Pass,220,60,280
M1614037, College : 5217  -  KUMUD BEN DARBAR COLLEGE OF B.C.A.  VIJAYAPURA,N.C.L,--   ,SOFTWARE PRACTICES AND TESTING ,Pass,42,8,50,BUSINESS INTELLIGENCE ,Pass,32,8,40,J2EE ,Pass,55,12,67,J2EE AND SOFTWARE TESTING LABORATORY,Pass,77,20,97,PROJECT AND VIVA VOCE ,Pass,240,60,300
M1614038, College : 5217  -  KUMUD BEN DARBAR COLLEGE OF B.C.A.  VIJAYAPURA,DISTI,76.43,SOFTWARE PRACTICES AND TESTING ,Pass,49,15,64,BUSINESS INTELLIGENCE ,Pass,65,13,78,J2EE ,Pass,46,9,55,J2EE AND SOFTWARE TESTING LABORATORY,Pass,71,18,89,PROJECT AND VIVA VOCE ,Pass,220,58,278
M1614041, College : 5217  -  KUMUD BEN DARBAR COLLEGE OF B.C.A.  VIJAYAPURA,DISTI,80.73,SOFTWARE PRACTICES AND TESTING ,Pass,59,16,75,BUSINESS INTELLIGENCE ,Pass,65,13,78,J2EE ,Pass,49,13,62,J2EE AND SOFTWARE TESTING LABORATORY,Pass,76,20,96,PROJECT AND VIVA VOCE ,Pass,230,60,290
M1614042, College : 5217  -  KUMUD BEN DARBAR COLLEGE OF B.C.A.  VIJAYAPURA,DISTI,82.22,SOFTWARE PRACTICES AND TESTING ,Pass,62,16,78,BUSINESS INTELLIGENCE ,Pass,52,16,68,J2EE ,Pass,56,15,71,J2EE AND SOFTWARE TESTING LABORATORY,Pass,78,20,98,PROJECT AND VIVA VOCE ,Pass,220,60,280
M1614043, College : 5217  -  KUMUD BEN DARBAR COLLEGE OF B.C.A.  VIJAYAPURA,1ST C,68.89,SOFTWARE PRACTICES AND TESTING ,Pass,38,13,51,BUSINESS INTELLIGENCE ,Pass,52,12,64,J2EE ,Pass,45,14,59,J2EE AND SOFTWARE TESTING LABORATORY,Pass,77,20,97,PROJECT AND VIVA VOCE ,Pass,220,60,280
M1614044, College : 5217  -  KUMUD BEN DARBAR COLLEGE OF B.C.A.  VIJAYAPURA,DISTI,72.86,SOFTWARE PRACTICES AND TESTING ,Pass,42,10,52,BUSINESS INTELLIGENCE ,Pass,64,14,78,J2EE ,Pass,50,13,63,J2EE AND SOFTWARE TESTING LABORATORY,Pass,79,19,98,PROJECT AND VIVA VOCE ,Pass,230,59,289
M1614045, College : 5217  -  KUMUD BEN DARBAR COLLEGE OF B.C.A.  VIJAYAPURA,DISTI,80.24,SOFTWARE PRACTICES AND TESTING ,Pass,56,19,75,BUSINESS INTELLIGENCE ,Pass,63,16,79,J2EE ,Pass,48,16,64,J2EE AND SOFTWARE TESTING LABORATORY,Pass,79,20,99,PROJECT AND VIVA VOCE ,Pass,220,60,280
M1614047, College : 5217  -  KUMUD BEN DARBAR COLLEGE OF B.C.A.  VIJAYAPURA,DISTI,75.11,SOFTWARE PRACTICES AND TESTING ,Pass,49,16,65,BUSINESS INTELLIGENCE ,Pass,66,13,79,J2EE ,Pass,55,16,71,J2EE AND SOFTWARE TESTING LABORATORY,Pass,78,20,98,PROJECT AND VIVA VOCE ,Pass,230,60,290
M1614049, College : 5217  -  KUMUD BEN DARBAR COLLEGE OF B.C.A.  VIJAYAPURA,DISTI,78.38,SOFTWARE PRACTICES AND TESTING ,Pass,58,18,76,BUSINESS INTELLIGENCE ,Pass,64,16,80,J2EE ,Pass,50,18,68,J2EE AND SOFTWARE TESTING LABORATORY,Pass,78,20,98,PROJECT AND VIVA VOCE ,Pass,230,60,290
M1614050, College : 5217  -  KUMUD BEN DARBAR COLLEGE OF B.C.A.  VIJAYAPURA,N.C.L,--   ,SOFTWARE PRACTICES AND TESTING ,Pass,56,20,76,BUSINESS INTELLIGENCE ,Pass,63,19,82,J2EE ,Pass,53,19,72,J2EE AND SOFTWARE TESTING LABORATORY,Pass,70,18,88,PROJECT AND VIVA VOCE ,Pass,225,55,280
M1614052, College : 5217  -  KUMUD BEN DARBAR COLLEGE OF B.C.A.  VIJAYAPURA,DISTI,73.89,SOFTWARE PRACTICES AND TESTING ,Pass,56,11,67,BUSINESS INTELLIGENCE ,Pass,49,10,59,J2EE ,Pass,34,10,44,J2EE AND SOFTWARE TESTING LABORATORY,Pass,75,19,94,PROJECT AND VIVA VOCE ,Pass,220,58,278
M1614053, College : 5217  -  KUMUD BEN DARBAR COLLEGE OF B.C.A.  VIJAYAPURA,FAIL,66.71,SOFTWARE PRACTICES AND TESTING ,Pass,32,11,43,BUSINESS INTELLIGENCE ,Pass,38,8,46,J2EE ,Fail,16,11,27,J2EE AND SOFTWARE TESTING LABORATORY,Pass,74,19,93,PROJECT AND VIVA VOCE ,Pass,200,58,258
M1614054, College : 5217  -  KUMUD BEN DARBAR COLLEGE OF B.C.A.  VIJAYAPURA,N.C.L,--   ,SOFTWARE PRACTICES AND TESTING ,Pass,45,17,62,BUSINESS INTELLIGENCE ,Pass,48,16,64,J2EE ,Pass,42,16,58,J2EE AND SOFTWARE TESTING LABORATORY,Pass,75,16,91,PROJECT AND VIVA VOCE ,Pass,236,55,291
M1614056, College : 5217  -  KUMUD BEN DARBAR COLLEGE OF B.C.A.  VIJAYAPURA,1ST C,67.05,SOFTWARE PRACTICES AND TESTING ,Pass,37,9,46,BUSINESS INTELLIGENCE ,Pass,55,9,64,J2EE ,Pass,32,9,41,J2EE AND SOFTWARE TESTING LABORATORY,Pass,76,20,96,PROJECT AND VIVA VOCE ,Pass,210,60,270
M1614057, College : 5217  -  KUMUD BEN DARBAR COLLEGE OF B.C.A.  VIJAYAPURA,N.C.L,--   ,SOFTWARE PRACTICES AND TESTING ,Pass,45,14,59,BUSINESS INTELLIGENCE ,Pass,33,13,46,J2EE ,Pass,37,16,53,J2EE AND SOFTWARE TESTING LABORATORY,Pass,69,16,85,PROJECT AND VIVA VOCE ,Pass,224,56,280
M1614201, College : 5238  -  S P V V SANGH S G.P. PORWAL B.C.A COLLEGE  SINDAGI,DISTI,74.46,SOFTWARE PRACTICES AND TESTING ,Pass,43,19,62,BUSINESS INTELLIGENCE ,Pass,54,17,71,J2EE ,Pass,51,18,69,J2EE AND SOFTWARE TESTING LABORATORY,Pass,79,19,98,PROJECT AND VIVA VOCE ,Pass,240,60,300
M1614202, College : 5238  -  S P V V SANGH S G.P. PORWAL B.C.A COLLEGE  SINDAGI,DISTI,72.97,SOFTWARE PRACTICES AND TESTING ,Pass,51,17,68,BUSINESS INTELLIGENCE ,Pass,56,16,72,J2EE ,Pass,48,17,65,J2EE AND SOFTWARE TESTING LABORATORY,Pass,75,18,93,PROJECT AND VIVA VOCE ,Pass,234,55,289
M1614203, College : 5238  -  S P V V SANGH S G.P. PORWAL B.C.A COLLEGE  SINDAGI,DISTI,78.59,SOFTWARE PRACTICES AND TESTING ,Pass,58,19,77,BUSINESS INTELLIGENCE ,Pass,57,18,75,J2EE ,Pass,57,18,75,J2EE AND SOFTWARE TESTING LABORATORY,Pass,79,19,98,PROJECT AND VIVA VOCE ,Pass,240,60,300
M1614204, College : 5238  -  S P V V SANGH S G.P. PORWAL B.C.A COLLEGE  SINDAGI,DISTI,78.92,SOFTWARE PRACTICES AND TESTING ,Pass,42,19,61,BUSINESS INTELLIGENCE ,Pass,58,20,78,J2EE ,Pass,55,19,74,J2EE AND SOFTWARE TESTING LABORATORY,Pass,80,20,100,PROJECT AND VIVA VOCE ,Pass,240,59,299
M1614207, College : 5238  -  S P V V SANGH S G.P. PORWAL B.C.A COLLEGE  SINDAGI,DISTI,75.32,SOFTWARE PRACTICES AND TESTING ,Pass,50,19,69,BUSINESS INTELLIGENCE ,Pass,47,19,66,J2EE ,Pass,52,19,71,J2EE AND SOFTWARE TESTING LABORATORY,Pass,80,19,99,PROJECT AND VIVA VOCE ,Pass,239,55,294
M1614208, College : 5238  -  S P V V SANGH S G.P. PORWAL B.C.A COLLEGE  SINDAGI,DISTI,75.51,SOFTWARE PRACTICES AND TESTING ,Pass,50,20,70,BUSINESS INTELLIGENCE ,Pass,46,20,66,J2EE ,Pass,44,19,63,J2EE AND SOFTWARE TESTING LABORATORY,Pass,80,20,100,PROJECT AND VIVA VOCE ,Pass,240,55,295
M1614209, College : 5238  -  S P V V SANGH S G.P. PORWAL B.C.A COLLEGE  SINDAGI,DISTI,82.49,SOFTWARE PRACTICES AND TESTING ,Pass,50,17,67,BUSINESS INTELLIGENCE ,Pass,53,19,72,J2EE ,Pass,53,19,72,J2EE AND SOFTWARE TESTING LABORATORY,Pass,80,19,99,PROJECT AND VIVA VOCE ,Pass,239,58,297
M1614211, College : 5238  -  S P V V SANGH S G.P. PORWAL B.C.A COLLEGE  SINDAGI,DISTI,81.08,SOFTWARE PRACTICES AND TESTING ,Pass,35,20,55,BUSINESS INTELLIGENCE ,Pass,54,20,74,J2EE ,Pass,52,20,72,J2EE AND SOFTWARE TESTING LABORATORY,Pass,80,20,100,PROJECT AND VIVA VOCE ,Pass,239,60,299
M1614212, College : 5238  -  S P V V SANGH S G.P. PORWAL B.C.A COLLEGE  SINDAGI,DISTI,75.05,SOFTWARE PRACTICES AND TESTING ,Pass,32,20,52,BUSINESS INTELLIGENCE ,Pass,39,20,59,J2EE ,Pass,58,20,78,J2EE AND SOFTWARE TESTING LABORATORY,Pass,80,20,100,PROJECT AND VIVA VOCE ,Pass,238,58,296
M1614213, College : 5238  -  S P V V SANGH S G.P. PORWAL B.C.A COLLEGE  SINDAGI,DISTI,71.16,SOFTWARE PRACTICES AND TESTING ,Pass,40,18,58,BUSINESS INTELLIGENCE ,Pass,36,16,52,J2EE ,Pass,60,16,76,J2EE AND SOFTWARE TESTING LABORATORY,Pass,75,19,94,PROJECT AND VIVA VOCE ,Pass,236,56,292
M1614215, College : 5238  -  S P V V SANGH S G.P. PORWAL B.C.A COLLEGE  SINDAGI,DISTI,72.27,SOFTWARE PRACTICES AND TESTING ,Pass,43,17,60,BUSINESS INTELLIGENCE ,Pass,44,16,60,J2EE ,Pass,57,17,74,J2EE AND SOFTWARE TESTING LABORATORY,Pass,77,19,96,PROJECT AND VIVA VOCE ,Pass,237,56,293
M1614216, College : 5238  -  S P V V SANGH S G.P. PORWAL B.C.A COLLEGE  SINDAGI,DISTI,70.14,SOFTWARE PRACTICES AND TESTING ,Pass,35,17,52,BUSINESS INTELLIGENCE ,Pass,56,17,73,J2EE ,Pass,49,18,67,J2EE AND SOFTWARE TESTING LABORATORY,Pass,75,19,94,PROJECT AND VIVA VOCE ,Pass,237,57,294
M1614217, College : 5238  -  S P V V SANGH S G.P. PORWAL B.C.A COLLEGE  SINDAGI,DISTI,70.92,SOFTWARE PRACTICES AND TESTING ,Pass,39,17,56,BUSINESS INTELLIGENCE ,Pass,63,17,80,J2EE ,Pass,53,16,69,J2EE AND SOFTWARE TESTING LABORATORY,Pass,75,19,94,PROJECT AND VIVA VOCE ,Pass,235,55,290
M1614218, College : 5238  -  S P V V SANGH S G.P. PORWAL B.C.A COLLEGE  SINDAGI,1ST C,68.35,SOFTWARE PRACTICES AND TESTING ,Pass,37,17,54,BUSINESS INTELLIGENCE ,Pass,56,15,71,J2EE ,Pass,50,16,66,J2EE AND SOFTWARE TESTING LABORATORY,Pass,74,19,93,PROJECT AND VIVA VOCE ,Pass,233,55,288
M1614220, College : 5238  -  S P V V SANGH S G.P. PORWAL B.C.A COLLEGE  SINDAGI,DISTI,84.95,SOFTWARE PRACTICES AND TESTING ,Pass,39,20,59,BUSINESS INTELLIGENCE ,Pass,65,20,85,J2EE ,Pass,59,20,79,J2EE AND SOFTWARE TESTING LABORATORY,Pass,80,20,100,PROJECT AND VIVA VOCE ,Pass,240,60,300
M1614221, College : 5238  -  S P V V SANGH S G.P. PORWAL B.C.A COLLEGE  SINDAGI,1ST C,68.73,SOFTWARE PRACTICES AND TESTING ,Pass,34,17,51,BUSINESS INTELLIGENCE ,Pass,56,15,71,J2EE ,Pass,41,16,57,J2EE AND SOFTWARE TESTING LABORATORY,Pass,75,19,94,PROJECT AND VIVA VOCE ,Pass,235,56,291
M1614222, College : 5238  -  S P V V SANGH S G.P. PORWAL B.C.A COLLEGE  SINDAGI,DISTI,70,SOFTWARE PRACTICES AND TESTING ,Pass,46,17,63,BUSINESS INTELLIGENCE ,Pass,58,15,73,J2EE ,Pass,32,16,48,J2EE AND SOFTWARE TESTING LABORATORY,Pass,75,17,92,PROJECT AND VIVA VOCE ,Pass,236,55,291
M1614223, College : 5238  -  S P V V SANGH S G.P. PORWAL B.C.A COLLEGE  SINDAGI,DISTI,70.22,SOFTWARE PRACTICES AND TESTING ,Pass,43,17,60,BUSINESS INTELLIGENCE ,Pass,54,15,69,J2EE ,Pass,42,16,58,J2EE AND SOFTWARE TESTING LABORATORY,Pass,75,18,93,PROJECT AND VIVA VOCE ,Pass,235,55,290
M1614225, College : 5238  -  S P V V SANGH S G.P. PORWAL B.C.A COLLEGE  SINDAGI,N.C.L,--   ,SOFTWARE PRACTICES AND TESTING ,Pass,45,20,65,BUSINESS INTELLIGENCE ,Pass,64,20,84,J2EE ,Pass,55,20,75,J2EE AND SOFTWARE TESTING LABORATORY,Pass,80,20,100,PROJECT AND VIVA VOCE ,Pass,240,58,298
M1614227, College : 5238  -  S P V V SANGH S G.P. PORWAL B.C.A COLLEGE  SINDAGI,DISTI,76.46,SOFTWARE PRACTICES AND TESTING ,Pass,44,19,63,BUSINESS INTELLIGENCE ,Pass,59,20,79,J2EE ,Pass,55,20,75,J2EE AND SOFTWARE TESTING LABORATORY,Pass,80,19,99,PROJECT AND VIVA VOCE ,Pass,240,59,299
M1614229, College : 5238  -  S P V V SANGH S G.P. PORWAL B.C.A COLLEGE  SINDAGI,N.C.L,--   ,SOFTWARE PRACTICES AND TESTING ,Pass,43,17,60,BUSINESS INTELLIGENCE ,Pass,57,15,72,J2EE ,Pass,42,16,58,J2EE AND SOFTWARE TESTING LABORATORY,Pass,77,18,95,PROJECT AND VIVA VOCE ,Pass,236,55,291
M1614230, College : 5238  -  S P V V SANGH S G.P. PORWAL B.C.A COLLEGE  SINDAGI,N.C.L,--   ,SOFTWARE PRACTICES AND TESTING ,Pass,36,17,53,BUSINESS INTELLIGENCE ,Pass,57,16,73,J2EE ,Pass,41,16,57,J2EE AND SOFTWARE TESTING LABORATORY,Pass,75,18,93,PROJECT AND VIVA VOCE ,Pass,235,55,290
M1614231, College : 5238  -  S P V V SANGH S G.P. PORWAL B.C.A COLLEGE  SINDAGI,N.C.L,--   ,SOFTWARE PRACTICES AND TESTING ,Pass,35,17,52,BUSINESS INTELLIGENCE ,Pass,57,19,76,J2EE ,Pass,41,16,57,J2EE AND SOFTWARE TESTING LABORATORY,Pass,75,18,93,PROJECT AND VIVA VOCE ,Pass,240,60,300
M1614232, College : 5238  -  S P V V SANGH S G.P. PORWAL B.C.A COLLEGE  SINDAGI,N.C.L,--   ,SOFTWARE PRACTICES AND TESTING ,Pass,33,19,52,BUSINESS INTELLIGENCE ,Pass,62,15,77,J2EE ,Pass,43,16,59,J2EE AND SOFTWARE TESTING LABORATORY,Pass,75,18,93,PROJECT AND VIVA VOCE ,Pass,234,55,289
M1614233, College : 5238  -  S P V V SANGH S G.P. PORWAL B.C.A COLLEGE  SINDAGI,DISTI,74.86,SOFTWARE PRACTICES AND TESTING ,Pass,46,20,66,BUSINESS INTELLIGENCE ,Pass,66,20,86,J2EE ,Pass,39,20,59,J2EE AND SOFTWARE TESTING LABORATORY,Pass,80,20,100,PROJECT AND VIVA VOCE ,Pass,240,60,300
M1614234, College : 5238  -  S P V V SANGH S G.P. PORWAL B.C.A COLLEGE  SINDAGI,DISTI,71.7,SOFTWARE PRACTICES AND TESTING ,Pass,47,18,65,BUSINESS INTELLIGENCE ,Pass,61,15,76,J2EE ,Pass,36,16,52,J2EE AND SOFTWARE TESTING LABORATORY,Pass,75,19,94,PROJECT AND VIVA VOCE ,Pass,234,55,289
M1614235, College : 5238  -  S P V V SANGH S G.P. PORWAL B.C.A COLLEGE  SINDAGI,N.C.L,--   ,SOFTWARE PRACTICES AND TESTING ,Pass,44,17,61,BUSINESS INTELLIGENCE ,Pass,58,15,73,J2EE ,Pass,36,16,52,J2EE AND SOFTWARE TESTING LABORATORY,Pass,75,18,93,PROJECT AND VIVA VOCE ,Pass,234,55,289
M1614236, College : 5238  -  S P V V SANGH S G.P. PORWAL B.C.A COLLEGE  SINDAGI,N.C.L,--   ,SOFTWARE PRACTICES AND TESTING ,Pass,42,17,59,BUSINESS INTELLIGENCE ,Pass,41,17,58,J2EE ,Pass,38,16,54,J2EE AND SOFTWARE TESTING LABORATORY,Pass,80,19,99,PROJECT AND VIVA VOCE ,Pass,240,59,299
M1614237, College : 5238  -  S P V V SANGH S G.P. PORWAL B.C.A COLLEGE  SINDAGI,1ST C,68.78,SOFTWARE PRACTICES AND TESTING ,Pass,35,17,52,BUSINESS INTELLIGENCE ,Pass,53,17,70,J2EE ,Pass,37,18,55,J2EE AND SOFTWARE TESTING LABORATORY,Pass,75,19,94,PROJECT AND VIVA VOCE ,Pass,239,59,298
M1614238, College : 5238  -  S P V V SANGH S G.P. PORWAL B.C.A COLLEGE  SINDAGI,DISTI,78,SOFTWARE PRACTICES AND TESTING ,Pass,43,20,63,BUSINESS INTELLIGENCE ,Pass,62,20,82,J2EE ,Pass,51,20,71,J2EE AND SOFTWARE TESTING LABORATORY,Pass,80,20,100,PROJECT AND VIVA VOCE ,Pass,240,57,297
M1614239, College : 5238  -  S P V V SANGH S G.P. PORWAL B.C.A COLLEGE  SINDAGI,N.C.L,--   ,SOFTWARE PRACTICES AND TESTING ,Pass,38,17,55,BUSINESS INTELLIGENCE ,Pass,57,15,72,J2EE ,Pass,41,16,57,J2EE AND SOFTWARE TESTING LABORATORY,Pass,76,20,96,PROJECT AND VIVA VOCE ,Pass,236,55,291
M1614240, College : 5238  -  S P V V SANGH S G.P. PORWAL B.C.A COLLEGE  SINDAGI,N.C.L,--   ,SOFTWARE PRACTICES AND TESTING ,Pass,41,17,58,BUSINESS INTELLIGENCE ,Pass,58,15,73,J2EE ,Pass,34,16,50,J2EE AND SOFTWARE TESTING LABORATORY,Pass,75,19,94,PROJECT AND VIVA VOCE ,Pass,235,55,290
M1614242, College : 5238  -  S P V V SANGH S G.P. PORWAL B.C.A COLLEGE  SINDAGI,1ST C,69.19,SOFTWARE PRACTICES AND TESTING ,Pass,42,18,60,BUSINESS INTELLIGENCE ,Pass,60,15,75,J2EE ,Pass,49,17,66,J2EE AND SOFTWARE TESTING LABORATORY,Pass,75,19,94,PROJECT AND VIVA VOCE ,Pass,235,55,290
M1614243, College : 5238  -  S P V V SANGH S G.P. PORWAL B.C.A COLLEGE  SINDAGI,DISTI,73,SOFTWARE PRACTICES AND TESTING ,Pass,42,18,60,BUSINESS INTELLIGENCE ,Pass,57,17,74,J2EE ,Pass,53,17,70,J2EE AND SOFTWARE TESTING LABORATORY,Pass,79,18,97,PROJECT AND VIVA VOCE ,Pass,239,55,294
M1614244, College : 5238  -  S P V V SANGH S G.P. PORWAL B.C.A COLLEGE  SINDAGI,DISTI,76.03,SOFTWARE PRACTICES AND TESTING ,Pass,51,18,69,BUSINESS INTELLIGENCE ,Pass,52,19,71,J2EE ,Pass,54,20,74,J2EE AND SOFTWARE TESTING LABORATORY,Pass,80,19,99,PROJECT AND VIVA VOCE ,Pass,240,58,298
M1614245, College : 5238  -  S P V V SANGH S G.P. PORWAL B.C.A COLLEGE  SINDAGI,DISTI,73.81,SOFTWARE PRACTICES AND TESTING ,Pass,32,20,52,BUSINESS INTELLIGENCE ,Pass,52,20,72,J2EE ,Pass,44,20,64,J2EE AND SOFTWARE TESTING LABORATORY,Pass,80,20,100,PROJECT AND VIVA VOCE ,Pass,240,59,299
M1614246, College : 5238  -  S P V V SANGH S G.P. PORWAL B.C.A COLLEGE  SINDAGI,N.C.L,--   ,SOFTWARE PRACTICES AND TESTING ,Pass,37,18,55,BUSINESS INTELLIGENCE ,Pass,49,15,64,J2EE ,Pass,49,16,65,J2EE AND SOFTWARE TESTING LABORATORY,Pass,75,19,94,PROJECT AND VIVA VOCE ,Pass,234,56,290
M1614247, College : 5238  -  S P V V SANGH S G.P. PORWAL B.C.A COLLEGE  SINDAGI,DISTI,71.19,SOFTWARE PRACTICES AND TESTING ,Pass,34,17,51,BUSINESS INTELLIGENCE ,Pass,43,20,63,J2EE ,Pass,46,20,66,J2EE AND SOFTWARE TESTING LABORATORY,Pass,75,19,94,PROJECT AND VIVA VOCE ,Pass,236,58,294
M1614248, College : 5238  -  S P V V SANGH S G.P. PORWAL B.C.A COLLEGE  SINDAGI,N.C.L,--   ,SOFTWARE PRACTICES AND TESTING ,Pass,41,19,60,BUSINESS INTELLIGENCE ,Pass,48,18,66,J2EE ,Pass,47,16,63,J2EE AND SOFTWARE TESTING LABORATORY,Pass,73,19,92,PROJECT AND VIVA VOCE ,Pass,237,58,295
M1614249, College : 5238  -  S P V V SANGH S G.P. PORWAL B.C.A COLLEGE  SINDAGI,N.C.L,--   ,SOFTWARE PRACTICES AND TESTING ,Pass,39,17,56,BUSINESS INTELLIGENCE ,Pass,46,20,66,J2EE ,Pass,50,18,68,J2EE AND SOFTWARE TESTING LABORATORY,Pass,74,19,93,PROJECT AND VIVA VOCE ,Pass,235,58,293
M1614251, College : 5238  -  S P V V SANGH S G.P. PORWAL B.C.A COLLEGE  SINDAGI,1ST C,65.84,SOFTWARE PRACTICES AND TESTING ,Pass,37,17,54,BUSINESS INTELLIGENCE ,Pass,45,15,60,J2EE ,Pass,50,16,66,J2EE AND SOFTWARE TESTING LABORATORY,Pass,74,19,93,PROJECT AND VIVA VOCE ,Pass,234,55,289
M1614252, College : 5238  -  S P V V SANGH S G.P. PORWAL B.C.A COLLEGE  SINDAGI,N.C.L,--   ,SOFTWARE PRACTICES AND TESTING ,Pass,36,17,53,BUSINESS INTELLIGENCE ,Pass,46,15,61,J2EE ,Pass,52,16,68,J2EE AND SOFTWARE TESTING LABORATORY,Pass,72,19,91,PROJECT AND VIVA VOCE ,Pass,233,55,288
M1614253, College : 5238  -  S P V V SANGH S G.P. PORWAL B.C.A COLLEGE  SINDAGI,DISTI,70,SOFTWARE PRACTICES AND TESTING ,Pass,38,18,56,BUSINESS INTELLIGENCE ,Pass,55,17,72,J2EE ,Pass,49,19,68,J2EE AND SOFTWARE TESTING LABORATORY,Pass,78,18,96,PROJECT AND VIVA VOCE ,Pass,237,59,296
M1614254, College : 5238  -  S P V V SANGH S G.P. PORWAL B.C.A COLLEGE  SINDAGI,N.C.L,--   ,SOFTWARE PRACTICES AND TESTING ,Pass,32,18,50,BUSINESS INTELLIGENCE ,Pass,48,15,63,J2EE ,Pass,38,16,54,J2EE AND SOFTWARE TESTING LABORATORY,Pass,78,18,96,PROJECT AND VIVA VOCE ,Pass,238,58,296
M1614255, College : 5238  -  S P V V SANGH S G.P. PORWAL B.C.A COLLEGE  SINDAGI,N.C.L,--   ,SOFTWARE PRACTICES AND TESTING ,Pass,34,20,54,BUSINESS INTELLIGENCE ,Pass,38,19,57,J2EE ,Pass,52,19,71,J2EE AND SOFTWARE TESTING LABORATORY,Pass,80,20,100,PROJECT AND VIVA VOCE ,Pass,240,57,297
M1614256, College : 5238  -  S P V V SANGH S G.P. PORWAL B.C.A COLLEGE  SINDAGI,N.C.L,--   ,SOFTWARE PRACTICES AND TESTING ,Pass,32,17,49,BUSINESS INTELLIGENCE ,Pass,39,15,54,J2EE ,Pass,41,16,57,J2EE AND SOFTWARE TESTING LABORATORY,Pass,76,18,94,PROJECT AND VIVA VOCE ,Pass,236,55,291
M1614257, College : 5238  -  S P V V SANGH S G.P. PORWAL B.C.A COLLEGE  SINDAGI,DISTI,75.27,SOFTWARE PRACTICES AND TESTING ,Pass,55,17,72,BUSINESS INTELLIGENCE ,Pass,48,16,64,J2EE ,Pass,52,16,68,J2EE AND SOFTWARE TESTING LABORATORY,Pass,76,18,94,PROJECT AND VIVA VOCE ,Pass,236,55,291
M1614258, College : 5238  -  S P V V SANGH S G.P. PORWAL B.C.A COLLEGE  SINDAGI,N.C.L,--   ,SOFTWARE PRACTICES AND TESTING ,Pass,32,18,50,BUSINESS INTELLIGENCE ,Pass,56,18,74,J2EE ,Pass,43,16,59,J2EE AND SOFTWARE TESTING LABORATORY,Pass,75,19,94,PROJECT AND VIVA VOCE ,Pass,239,59,298
M1614259, College : 5238  -  S P V V SANGH S G.P. PORWAL B.C.A COLLEGE  SINDAGI,DISTI,77.08,SOFTWARE PRACTICES AND TESTING ,Pass,52,18,70,BUSINESS INTELLIGENCE ,Pass,57,18,75,J2EE ,Pass,52,18,70,J2EE AND SOFTWARE TESTING LABORATORY,Pass,80,18,98,PROJECT AND VIVA VOCE ,Pass,239,57,296
M1614260, College : 5238  -  S P V V SANGH S G.P. PORWAL B.C.A COLLEGE  SINDAGI,DISTI,74.62,SOFTWARE PRACTICES AND TESTING ,Pass,38,17,55,BUSINESS INTELLIGENCE ,Pass,48,18,66,J2EE ,Pass,43,19,62,J2EE AND SOFTWARE TESTING LABORATORY,Pass,79,17,96,PROJECT AND VIVA VOCE ,Pass,236,58,294
M1614261, College : 5238  -  S P V V SANGH S G.P. PORWAL B.C.A COLLEGE  SINDAGI,N.C.L,--   ,SOFTWARE PRACTICES AND TESTING ,Pass,43,18,61,BUSINESS INTELLIGENCE ,Pass,49,20,69,J2EE ,Pass,44,20,64,J2EE AND SOFTWARE TESTING LABORATORY,Pass,76,18,94,PROJECT AND VIVA VOCE ,Pass,235,60,295
M1614264, College : 5238  -  S P V V SANGH S G.P. PORWAL B.C.A COLLEGE  SINDAGI,N.C.L,--   ,SOFTWARE PRACTICES AND TESTING ,Pass,38,17,55,BUSINESS INTELLIGENCE ,Pass,46,15,61,J2EE ,Pass,44,16,60,J2EE AND SOFTWARE TESTING LABORATORY,Pass,75,18,93,PROJECT AND VIVA VOCE ,Pass,234,58,292
M1614265, College : 5238  -  S P V V SANGH S G.P. PORWAL B.C.A COLLEGE  SINDAGI,1ST C,68.35,SOFTWARE PRACTICES AND TESTING ,Pass,46,17,63,BUSINESS INTELLIGENCE ,Pass,47,15,62,J2EE ,Pass,47,16,63,J2EE AND SOFTWARE TESTING LABORATORY,Pass,76,18,94,PROJECT AND VIVA VOCE ,Pass,234,55,289
M1614266, College : 5238  -  S P V V SANGH S G.P. PORWAL B.C.A COLLEGE  SINDAGI,DISTI,74.43,SOFTWARE PRACTICES AND TESTING ,Pass,45,20,65,BUSINESS INTELLIGENCE ,Pass,54,20,74,J2EE ,Pass,47,20,67,J2EE AND SOFTWARE TESTING LABORATORY,Pass,80,20,100,PROJECT AND VIVA VOCE ,Pass,240,60,300
M1614267, College : 5238  -  S P V V SANGH S G.P. PORWAL B.C.A COLLEGE  SINDAGI,DISTI,70.11,SOFTWARE PRACTICES AND TESTING ,Pass,40,17,57,BUSINESS INTELLIGENCE ,Pass,51,15,66,J2EE ,Pass,45,16,61,J2EE AND SOFTWARE TESTING LABORATORY,Pass,80,18,98,PROJECT AND VIVA VOCE ,Pass,240,59,299
M1614268, College : 5238  -  S P V V SANGH S G.P. PORWAL B.C.A COLLEGE  SINDAGI,DISTI,75.76,SOFTWARE PRACTICES AND TESTING ,Pass,48,20,68,BUSINESS INTELLIGENCE ,Pass,58,20,78,J2EE ,Pass,46,20,66,J2EE AND SOFTWARE TESTING LABORATORY,Pass,80,20,100,PROJECT AND VIVA VOCE ,Pass,240,59,299
M1614269, College : 5238  -  S P V V SANGH S G.P. PORWAL B.C.A COLLEGE  SINDAGI,N.C.L,--   ,SOFTWARE PRACTICES AND TESTING ,Pass,36,20,56,BUSINESS INTELLIGENCE ,Pass,55,20,75,J2EE ,Pass,32,20,52,J2EE AND SOFTWARE TESTING LABORATORY,Pass,80,20,100,PROJECT AND VIVA VOCE ,Pass,240,60,300
M1614270, College : 5238  -  S P V V SANGH S G.P. PORWAL B.C.A COLLEGE  SINDAGI,DISTI,71.73,SOFTWARE PRACTICES AND TESTING ,Pass,41,20,61,BUSINESS INTELLIGENCE ,Pass,53,19,72,J2EE ,Pass,43,19,62,J2EE AND SOFTWARE TESTING LABORATORY,Pass,80,20,100,PROJECT AND VIVA VOCE ,Pass,240,59,299
M1614271, College : 5238  -  S P V V SANGH S G.P. PORWAL B.C.A COLLEGE  SINDAGI,DISTI,71.84,SOFTWARE PRACTICES AND TESTING ,Pass,52,17,69,BUSINESS INTELLIGENCE ,Pass,56,17,73,J2EE ,Pass,48,16,64,J2EE AND SOFTWARE TESTING LABORATORY,Pass,75,17,92,PROJECT AND VIVA VOCE ,Pass,234,57,291
M1614272, College : 5238  -  S P V V SANGH S G.P. PORWAL B.C.A COLLEGE  SINDAGI,FAIL,17.29,SOFTWARE PRACTICES AND TESTING ,Fail,Ab.,17,17,BUSINESS INTELLIGENCE ,Fail,Ab.,15,15,J2EE ,Fail,Ab.,16,16,J2EE AND SOFTWARE TESTING LABORATORY,Fail,Ab.,18,18,PROJECT AND VIVA VOCE ,Fail,Ab.,55,55
M1614273, College : 5238  -  S P V V SANGH S G.P. PORWAL B.C.A COLLEGE  SINDAGI,DISTI,87.62,SOFTWARE PRACTICES AND TESTING ,Pass,62,20,82,BUSINESS INTELLIGENCE ,Pass,70,20,90,J2EE ,Pass,55,20,75,J2EE AND SOFTWARE TESTING LABORATORY,Pass,80,20,100,PROJECT AND VIVA VOCE ,Pass,240,60,300
M1614275, College : 5238  -  S P V V SANGH S G.P. PORWAL B.C.A COLLEGE  SINDAGI,DISTI,71.78,SOFTWARE PRACTICES AND TESTING ,Pass,52,17,69,BUSINESS INTELLIGENCE ,Pass,60,15,75,J2EE ,Pass,52,16,68,J2EE AND SOFTWARE TESTING LABORATORY,Pass,76,17,93,PROJECT AND VIVA VOCE ,Pass,235,55,290
M1614276, College : 5238  -  S P V V SANGH S G.P. PORWAL B.C.A COLLEGE  SINDAGI,N.C.L,--   ,SOFTWARE PRACTICES AND TESTING ,Pass,33,17,50,BUSINESS INTELLIGENCE ,Pass,46,15,61,J2EE ,Pass,47,16,63,J2EE AND SOFTWARE TESTING LABORATORY,Pass,76,17,93,PROJECT AND VIVA VOCE ,Pass,237,55,292
M1614277, College : 5238  -  S P V V SANGH S G.P. PORWAL B.C.A COLLEGE  SINDAGI,N.C.L,--   ,SOFTWARE PRACTICES AND TESTING ,Pass,39,17,56,BUSINESS INTELLIGENCE ,Pass,49,15,64,J2EE ,Pass,49,16,65,J2EE AND SOFTWARE TESTING LABORATORY,Pass,75,18,93,PROJECT AND VIVA VOCE ,Pass,234,55,289
M1614279, College : 5238  -  S P V V SANGH S G.P. PORWAL B.C.A COLLEGE  SINDAGI,DISTI,73.89,SOFTWARE PRACTICES AND TESTING ,Pass,37,20,57,BUSINESS INTELLIGENCE ,Pass,54,20,74,J2EE ,Pass,45,20,65,J2EE AND SOFTWARE TESTING LABORATORY,Pass,80,20,100,PROJECT AND VIVA VOCE ,Pass,239,57,296
M1614280, College : 5238  -  S P V V SANGH S G.P. PORWAL B.C.A COLLEGE  SINDAGI,1ST C,68.49,SOFTWARE PRACTICES AND TESTING ,Pass,34,18,52,BUSINESS INTELLIGENCE ,Pass,60,15,75,J2EE ,Pass,38,16,54,J2EE AND SOFTWARE TESTING LABORATORY,Pass,75,18,93,PROJECT AND VIVA VOCE ,Pass,239,55,294
M1614281, College : 5238  -  S P V V SANGH S G.P. PORWAL B.C.A COLLEGE  SINDAGI,N.C.L,--   ,SOFTWARE PRACTICES AND TESTING ,Pass,36,19,55,BUSINESS INTELLIGENCE ,Pass,57,20,77,J2EE ,Pass,53,19,72,J2EE AND SOFTWARE TESTING LABORATORY,Pass,80,19,99,PROJECT AND VIVA VOCE ,Pass,240,58,298
M1614282, College : 5238  -  S P V V SANGH S G.P. PORWAL B.C.A COLLEGE  SINDAGI,N.C.L,--   ,SOFTWARE PRACTICES AND TESTING ,Pass,41,17,58,BUSINESS INTELLIGENCE ,Pass,54,18,72,J2EE ,Pass,49,19,68,J2EE AND SOFTWARE TESTING LABORATORY,Pass,74,18,92,PROJECT AND VIVA VOCE ,Pass,235,56,291
M1614283, College : 5238  -  S P V V SANGH S G.P. PORWAL B.C.A COLLEGE  SINDAGI,DISTI,74.7,SOFTWARE PRACTICES AND TESTING ,Pass,44,20,64,BUSINESS INTELLIGENCE ,Pass,57,18,75,J2EE ,Pass,48,18,66,J2EE AND SOFTWARE TESTING LABORATORY,Pass,80,18,98,PROJECT AND VIVA VOCE ,Pass,240,55,295
M1614284, College : 5238  -  S P V V SANGH S G.P. PORWAL B.C.A COLLEGE  SINDAGI,N.C.L,--   ,SOFTWARE PRACTICES AND TESTING ,Pass,45,20,65,BUSINESS INTELLIGENCE ,Pass,52,19,71,J2EE ,Pass,44,19,63,J2EE AND SOFTWARE TESTING LABORATORY,Pass,80,20,100,PROJECT AND VIVA VOCE ,Pass,240,57,297
M1614285, College : 5238  -  S P V V SANGH S G.P. PORWAL B.C.A COLLEGE  SINDAGI,N.C.L,--   ,SOFTWARE PRACTICES AND TESTING ,Pass,54,17,71,BUSINESS INTELLIGENCE ,Pass,60,15,75,J2EE ,Pass,60,16,76,J2EE AND SOFTWARE TESTING LABORATORY,Pass,75,18,93,PROJECT AND VIVA VOCE ,Pass,230,55,285
M1614286, College : 5238  -  S P V V SANGH S G.P. PORWAL B.C.A COLLEGE  SINDAGI,DISTI,88,SOFTWARE PRACTICES AND TESTING ,Pass,56,20,76,BUSINESS INTELLIGENCE ,Pass,54,20,74,J2EE ,Pass,62,20,82,J2EE AND SOFTWARE TESTING LABORATORY,Pass,80,20,100,PROJECT AND VIVA VOCE ,Pass,240,60,300
M1614287, College : 5238  -  S P V V SANGH S G.P. PORWAL B.C.A COLLEGE  SINDAGI,DISTI,80.81,SOFTWARE PRACTICES AND TESTING ,Pass,49,20,69,BUSINESS INTELLIGENCE ,Pass,53,20,73,J2EE ,Pass,60,20,80,J2EE AND SOFTWARE TESTING LABORATORY,Pass,80,20,100,PROJECT AND VIVA VOCE ,Pass,240,60,300
M1614288, College : 5238  -  S P V V SANGH S G.P. PORWAL B.C.A COLLEGE  SINDAGI,1ST C,68.22,SOFTWARE PRACTICES AND TESTING ,Pass,35,18,53,BUSINESS INTELLIGENCE ,Pass,42,15,57,J2EE ,Pass,32,16,48,J2EE AND SOFTWARE TESTING LABORATORY,Pass,79,18,97,PROJECT AND VIVA VOCE ,Pass,239,55,294
M1614289, College : 5238  -  S P V V SANGH S G.P. PORWAL B.C.A COLLEGE  SINDAGI,DISTI,77.32,SOFTWARE PRACTICES AND TESTING ,Pass,43,17,60,BUSINESS INTELLIGENCE ,Pass,45,19,64,J2EE ,Pass,38,19,57,J2EE AND SOFTWARE TESTING LABORATORY,Pass,80,19,99,PROJECT AND VIVA VOCE ,Pass,240,58,298
M1614290, College : 5238  -  S P V V SANGH S G.P. PORWAL B.C.A COLLEGE  SINDAGI,DISTI,70,SOFTWARE PRACTICES AND TESTING ,Pass,41,17,58,BUSINESS INTELLIGENCE ,Pass,50,15,65,J2EE ,Pass,39,16,55,J2EE AND SOFTWARE TESTING LABORATORY,Pass,79,18,97,PROJECT AND VIVA VOCE ,Pass,237,55,292
M1614291, College : 5238  -  S P V V SANGH S G.P. PORWAL B.C.A COLLEGE  SINDAGI,1ST C,69.57,SOFTWARE PRACTICES AND TESTING ,Pass,34,17,51,BUSINESS INTELLIGENCE ,Pass,52,15,67,J2EE ,Pass,42,16,58,J2EE AND SOFTWARE TESTING LABORATORY,Pass,79,18,97,PROJECT AND VIVA VOCE ,Pass,235,55,290
M1614293, College : 5238  -  S P V V SANGH S G.P. PORWAL B.C.A COLLEGE  SINDAGI,N.C.L,--   ,SOFTWARE PRACTICES AND TESTING ,Pass,40,17,57,BUSINESS INTELLIGENCE ,Pass,48,15,63,J2EE ,Pass,44,16,60,J2EE AND SOFTWARE TESTING LABORATORY,Pass,76,18,94,PROJECT AND VIVA VOCE ,Pass,235,55,290
M1614294, College : 5238  -  S P V V SANGH S G.P. PORWAL B.C.A COLLEGE  SINDAGI,N.C.L,--   ,SOFTWARE PRACTICES AND TESTING ,Pass,49,18,67,BUSINESS INTELLIGENCE ,Pass,58,18,76,J2EE ,Pass,54,16,70,J2EE AND SOFTWARE TESTING LABORATORY,Pass,75,19,94,PROJECT AND VIVA VOCE ,Pass,240,58,298
M1614295, College : 5238  -  S P V V SANGH S G.P. PORWAL B.C.A COLLEGE  SINDAGI,N.C.L,--   ,SOFTWARE PRACTICES AND TESTING ,Pass,40,20,60,BUSINESS INTELLIGENCE ,Pass,54,16,70,J2EE ,Pass,60,16,76,J2EE AND SOFTWARE TESTING LABORATORY,Pass,80,19,99,PROJECT AND VIVA VOCE ,Pass,239,58,297
M1614296, College : 5238  -  S P V V SANGH S G.P. PORWAL B.C.A COLLEGE  SINDAGI,N.C.L,--   ,SOFTWARE PRACTICES AND TESTING ,Pass,38,17,55,BUSINESS INTELLIGENCE ,Pass,47,15,62,J2EE ,Pass,46,17,63,J2EE AND SOFTWARE TESTING LABORATORY,Pass,78,17,95,PROJECT AND VIVA VOCE ,Pass,237,55,292
M1614297, College : 5238  -  S P V V SANGH S G.P. PORWAL B.C.A COLLEGE  SINDAGI,N.C.L,--   ,SOFTWARE PRACTICES AND TESTING ,Pass,37,16,53,BUSINESS INTELLIGENCE ,Pass,60,15,75,J2EE ,Pass,36,16,52,J2EE AND SOFTWARE TESTING LABORATORY,Pass,70,17,87,PROJECT AND VIVA VOCE ,Pass,230,55,285
M1614401, College : 5248  -  CHETANA EDUCATION SOCIETY CHETANA B.C.A COLLEGE  VIJAYAPURA,N.C.L,--   ,SOFTWARE PRACTICES AND TESTING ,Pass,36,15,51,BUSINESS INTELLIGENCE ,Pass,42,19,61,J2EE ,Pass,32,20,52,J2EE AND SOFTWARE TESTING LABORATORY,Pass,80,20,100,PROJECT AND VIVA VOCE ,Pass,235,60,295
M1614403, College : 5248  -  CHETANA EDUCATION SOCIETY CHETANA B.C.A COLLEGE  VIJAYAPURA,N.C.L,--   ,SOFTWARE PRACTICES AND TESTING ,Pass,44,17,61,BUSINESS INTELLIGENCE ,Pass,47,16,63,J2EE ,Pass,32,18,50,J2EE AND SOFTWARE TESTING LABORATORY,Pass,78,18,96,PROJECT AND VIVA VOCE ,Pass,230,58,288
M1614404, College : 5248  -  CHETANA EDUCATION SOCIETY CHETANA B.C.A COLLEGE  VIJAYAPURA,N.C.L,--   ,SOFTWARE PRACTICES AND TESTING ,Pass,54,20,74,BUSINESS INTELLIGENCE ,Pass,49,20,69,J2EE ,Pass,32,18,50,J2EE AND SOFTWARE TESTING LABORATORY,Pass,78,18,96,PROJECT AND VIVA VOCE ,Pass,240,58,298
M1614405, College : 5248  -  CHETANA EDUCATION SOCIETY CHETANA B.C.A COLLEGE  VIJAYAPURA,FAIL,80.86,SOFTWARE PRACTICES AND TESTING ,Pass,43,20,63,BUSINESS INTELLIGENCE ,Pass,42,20,62,J2EE ,Fail,21,20,41,J2EE AND SOFTWARE TESTING LABORATORY,Pass,80,20,100,PROJECT AND VIVA VOCE ,Pass,240,60,300
M1614408, College : 5248  -  CHETANA EDUCATION SOCIETY CHETANA B.C.A COLLEGE  VIJAYAPURA,1ST C,62.27,SOFTWARE PRACTICES AND TESTING ,Pass,32,16,48,BUSINESS INTELLIGENCE ,Pass,32,16,48,J2EE ,Pass,32,18,50,J2EE AND SOFTWARE TESTING LABORATORY,Pass,78,18,96,PROJECT AND VIVA VOCE ,Pass,230,58,288
M1614409, College : 5248  -  CHETANA EDUCATION SOCIETY CHETANA B.C.A COLLEGE  VIJAYAPURA,DISTI,76.78,SOFTWARE PRACTICES AND TESTING ,Pass,41,18,59,BUSINESS INTELLIGENCE ,Pass,32,18,50,J2EE ,Pass,32,18,50,J2EE AND SOFTWARE TESTING LABORATORY,Pass,78,18,96,PROJECT AND VIVA VOCE ,Pass,235,58,293
M1614410, College : 5248  -  CHETANA EDUCATION SOCIETY CHETANA B.C.A COLLEGE  VIJAYAPURA,N.C.L,--   ,SOFTWARE PRACTICES AND TESTING ,Pass,33,18,51,BUSINESS INTELLIGENCE ,Pass,34,18,52,J2EE ,Pass,32,18,50,J2EE AND SOFTWARE TESTING LABORATORY,Pass,78,18,96,PROJECT AND VIVA VOCE ,Pass,230,58,288
M1614411, College : 5248  -  CHETANA EDUCATION SOCIETY CHETANA B.C.A COLLEGE  VIJAYAPURA,N.C.L,--   ,SOFTWARE PRACTICES AND TESTING ,Pass,34,15,49,BUSINESS INTELLIGENCE ,Pass,34,15,49,J2EE ,Pass,33,18,51,J2EE AND SOFTWARE TESTING LABORATORY,Pass,78,18,96,PROJECT AND VIVA VOCE ,Pass,230,58,288
M1614412, College : 5248  -  CHETANA EDUCATION SOCIETY CHETANA B.C.A COLLEGE  VIJAYAPURA,N.C.L,--   ,SOFTWARE PRACTICES AND TESTING ,Pass,32,20,52,BUSINESS INTELLIGENCE ,Pass,32,19,51,J2EE ,Pass,32,18,50,J2EE AND SOFTWARE TESTING LABORATORY,Pass,78,18,96,PROJECT AND VIVA VOCE ,Pass,235,58,293
M1614413, College : 5248  -  CHETANA EDUCATION SOCIETY CHETANA B.C.A COLLEGE  VIJAYAPURA,DISTI,81.11,SOFTWARE PRACTICES AND TESTING ,Pass,55,20,75,BUSINESS INTELLIGENCE ,Pass,54,20,74,J2EE ,Pass,33,18,51,J2EE AND SOFTWARE TESTING LABORATORY,Pass,80,18,98,PROJECT AND VIVA VOCE ,Pass,240,58,298
M1614414, College : 5248  -  CHETANA EDUCATION SOCIETY CHETANA B.C.A COLLEGE  VIJAYAPURA,N.C.L,--   ,SOFTWARE PRACTICES AND TESTING ,Pass,42,12,54,BUSINESS INTELLIGENCE ,Pass,46,12,58,J2EE ,Pass,32,18,50,J2EE AND SOFTWARE TESTING LABORATORY,Pass,76,18,94,PROJECT AND VIVA VOCE ,Pass,225,58,283
M1614416, College : 5248  -  CHETANA EDUCATION SOCIETY CHETANA B.C.A COLLEGE  VIJAYAPURA,N.C.L,--   ,SOFTWARE PRACTICES AND TESTING ,Pass,40,18,58,BUSINESS INTELLIGENCE ,Pass,43,19,62,J2EE ,Pass,32,20,52,J2EE AND SOFTWARE TESTING LABORATORY,Pass,80,20,100,PROJECT AND VIVA VOCE ,Pass,235,60,295
M1614417, College : 5248  -  CHETANA EDUCATION SOCIETY CHETANA B.C.A COLLEGE  VIJAYAPURA,DISTI,70,SOFTWARE PRACTICES AND TESTING ,Pass,35,19,54,BUSINESS INTELLIGENCE ,Pass,40,19,59,J2EE ,Pass,32,18,50,J2EE AND SOFTWARE TESTING LABORATORY,Pass,78,18,96,PROJECT AND VIVA VOCE ,Pass,235,58,293
M1614418, College : 5248  -  CHETANA EDUCATION SOCIETY CHETANA B.C.A COLLEGE  VIJAYAPURA,FAIL,73.14,SOFTWARE PRACTICES AND TESTING ,Fail,14,12,26,BUSINESS INTELLIGENCE ,Pass,34,17,51,J2EE ,Pass,32,20,52,J2EE AND SOFTWARE TESTING LABORATORY,Pass,78,20,98,PROJECT AND VIVA VOCE ,Pass,225,60,285
M1614419, College : 5248  -  CHETANA EDUCATION SOCIETY CHETANA B.C.A COLLEGE  VIJAYAPURA,FAIL,69.29,SOFTWARE PRACTICES AND TESTING ,Pass,36,12,48,BUSINESS INTELLIGENCE ,Pass,39,12,51,J2EE ,Fail,18,15,33,J2EE AND SOFTWARE TESTING LABORATORY,Pass,78,15,93,PROJECT AND VIVA VOCE ,Pass,210,50,260
M1614420, College : 5248  -  CHETANA EDUCATION SOCIETY CHETANA B.C.A COLLEGE  VIJAYAPURA,FAIL,81.29,SOFTWARE PRACTICES AND TESTING ,Pass,47,20,67,BUSINESS INTELLIGENCE ,Pass,40,20,60,J2EE ,Fail,22,20,42,J2EE AND SOFTWARE TESTING LABORATORY,Pass,80,20,100,PROJECT AND VIVA VOCE ,Pass,240,60,300
M1614421, College : 5248  -  CHETANA EDUCATION SOCIETY CHETANA B.C.A COLLEGE  VIJAYAPURA,DISTI,73.16,SOFTWARE PRACTICES AND TESTING ,Pass,33,20,53,BUSINESS INTELLIGENCE ,Pass,40,20,60,J2EE ,Pass,32,18,50,J2EE AND SOFTWARE TESTING LABORATORY,Pass,78,18,96,PROJECT AND VIVA VOCE ,Pass,230,58,288
M1614422, College : 5248  -  CHETANA EDUCATION SOCIETY CHETANA B.C.A COLLEGE  VIJAYAPURA,1ST C,67.78,SOFTWARE PRACTICES AND TESTING ,Pass,42,16,58,BUSINESS INTELLIGENCE ,Pass,60,16,76,J2EE ,Pass,34,18,52,J2EE AND SOFTWARE TESTING LABORATORY,Pass,78,18,96,PROJECT AND VIVA VOCE ,Pass,230,58,288
M1614423, College : 5248  -  CHETANA EDUCATION SOCIETY CHETANA B.C.A COLLEGE  VIJAYAPURA,DISTI,71.22,SOFTWARE PRACTICES AND TESTING ,Pass,36,15,51,BUSINESS INTELLIGENCE ,Pass,45,17,62,J2EE ,Pass,32,18,50,J2EE AND SOFTWARE TESTING LABORATORY,Pass,78,18,96,PROJECT AND VIVA VOCE ,Pass,235,58,293
M1614424, College : 5248  -  CHETANA EDUCATION SOCIETY CHETANA B.C.A COLLEGE  VIJAYAPURA,FAIL,81.29,SOFTWARE PRACTICES AND TESTING ,Pass,45,20,65,BUSINESS INTELLIGENCE ,Pass,60,19,79,J2EE ,Fail,23,18,41,J2EE AND SOFTWARE TESTING LABORATORY,Pass,78,18,96,PROJECT AND VIVA VOCE ,Pass,230,58,288
M1614425, College : 5248  -  CHETANA EDUCATION SOCIETY CHETANA B.C.A COLLEGE  VIJAYAPURA,DISTI,72.11,SOFTWARE PRACTICES AND TESTING ,Pass,50,20,70,BUSINESS INTELLIGENCE ,Pass,54,19,73,J2EE ,Pass,32,18,50,J2EE AND SOFTWARE TESTING LABORATORY,Pass,78,18,96,PROJECT AND VIVA VOCE ,Pass,230,58,288
M1614426, College : 5248  -  CHETANA EDUCATION SOCIETY CHETANA B.C.A COLLEGE  VIJAYAPURA,DISTI,78.57,SOFTWARE PRACTICES AND TESTING ,Pass,53,20,73,BUSINESS INTELLIGENCE ,Pass,54,20,74,J2EE ,Pass,32,18,50,J2EE AND SOFTWARE TESTING LABORATORY,Pass,80,18,98,PROJECT AND VIVA VOCE ,Pass,240,58,298
M1614427, College : 5248  -  CHETANA EDUCATION SOCIETY CHETANA B.C.A COLLEGE  VIJAYAPURA,N.C.L,--   ,SOFTWARE PRACTICES AND TESTING ,Pass,40,12,52,BUSINESS INTELLIGENCE ,Pass,41,12,53,J2EE ,Pass,32,15,47,J2EE AND SOFTWARE TESTING LABORATORY,Pass,76,15,91,PROJECT AND VIVA VOCE ,Pass,225,50,275
M1614601, College : 5256  -  RAMAKRISHNA VIVEKANAND BCA COLLEGE  TIDAGUNDI,N.C.L,--   ,SOFTWARE PRACTICES AND TESTING ,Pass,37,10,47,BUSINESS INTELLIGENCE ,Pass,60,15,75,J2EE ,Pass,40,15,55,J2EE AND SOFTWARE TESTING LABORATORY,Pass,70,12,82,PROJECT AND VIVA VOCE ,Pass,236,56,292
M1614602, College : 5256  -  RAMAKRISHNA VIVEKANAND BCA COLLEGE  TIDAGUNDI,DISTI,86.43,SOFTWARE PRACTICES AND TESTING ,Pass,62,17,79,BUSINESS INTELLIGENCE ,Pass,72,20,92,J2EE ,Pass,50,20,70,J2EE AND SOFTWARE TESTING LABORATORY,Pass,80,18,98,PROJECT AND VIVA VOCE ,Pass,240,58,298
M1614603, College : 5256  -  RAMAKRISHNA VIVEKANAND BCA COLLEGE  TIDAGUNDI,N.C.L,--   ,SOFTWARE PRACTICES AND TESTING ,Pass,42,10,52,BUSINESS INTELLIGENCE ,Pass,48,14,62,J2EE ,Pass,32,15,47,J2EE AND SOFTWARE TESTING LABORATORY,Pass,65,12,77,PROJECT AND VIVA VOCE ,Pass,230,52,282
M1614604, College : 5256  -  RAMAKRISHNA VIVEKANAND BCA COLLEGE  TIDAGUNDI,DISTI,71.24,SOFTWARE PRACTICES AND TESTING ,Pass,50,14,64,BUSINESS INTELLIGENCE ,Pass,63,17,80,J2EE ,Pass,38,18,56,J2EE AND SOFTWARE TESTING LABORATORY,Pass,70,14,84,PROJECT AND VIVA VOCE ,Pass,235,54,289
M1614605, College : 5256  -  RAMAKRISHNA VIVEKANAND BCA COLLEGE  TIDAGUNDI,N.C.L,--   ,SOFTWARE PRACTICES AND TESTING ,Pass,41,14,55,BUSINESS INTELLIGENCE ,Pass,59,15,74,J2EE ,Pass,40,15,55,J2EE AND SOFTWARE TESTING LABORATORY,Pass,70,14,84,PROJECT AND VIVA VOCE ,Pass,237,56,293
M1614606, College : 5256  -  RAMAKRISHNA VIVEKANAND BCA COLLEGE  TIDAGUNDI,N.C.L,--   ,SOFTWARE PRACTICES AND TESTING ,Pass,32,14,46,BUSINESS INTELLIGENCE ,Pass,60,15,75,J2EE ,Pass,38,15,53,J2EE AND SOFTWARE TESTING LABORATORY,Pass,68,14,82,PROJECT AND VIVA VOCE ,Pass,230,54,284
M1614607, College : 5256  -  RAMAKRISHNA VIVEKANAND BCA COLLEGE  TIDAGUNDI,N.C.L,--   ,SOFTWARE PRACTICES AND TESTING ,Pass,44,12,56,BUSINESS INTELLIGENCE ,Pass,58,13,71,J2EE ,Pass,38,14,52,J2EE AND SOFTWARE TESTING LABORATORY,Pass,68,14,82,PROJECT AND VIVA VOCE ,Pass,232,54,286
M1614608, College : 5256  -  RAMAKRISHNA VIVEKANAND BCA COLLEGE  TIDAGUNDI,FAIL,58.14,SOFTWARE PRACTICES AND TESTING ,Pass,32,15,47,BUSINESS INTELLIGENCE ,Pass,32,15,47,J2EE ,Fail,12,10,22,J2EE AND SOFTWARE TESTING LABORATORY,Pass,57,12,69,PROJECT AND VIVA VOCE ,Pass,170,52,222
M1614609, College : 5256  -  RAMAKRISHNA VIVEKANAND BCA COLLEGE  TIDAGUNDI,N.C.L,--   ,SOFTWARE PRACTICES AND TESTING ,Pass,41,13,54,BUSINESS INTELLIGENCE ,Pass,56,16,72,J2EE ,Pass,46,18,64,J2EE AND SOFTWARE TESTING LABORATORY,Pass,70,14,84,PROJECT AND VIVA VOCE ,Pass,233,54,287
M1614610, College : 5256  -  RAMAKRISHNA VIVEKANAND BCA COLLEGE  TIDAGUNDI,DISTI,82.78,SOFTWARE PRACTICES AND TESTING ,Pass,63,16,79,BUSINESS INTELLIGENCE ,Pass,74,17,91,J2EE ,Pass,60,19,79,J2EE AND SOFTWARE TESTING LABORATORY,Pass,80,16,96,PROJECT AND VIVA VOCE ,Pass,238,57,295
M1614611, College : 5256  -  RAMAKRISHNA VIVEKANAND BCA COLLEGE  TIDAGUNDI,N.C.L,--   ,SOFTWARE PRACTICES AND TESTING ,Pass,57,16,73,BUSINESS INTELLIGENCE ,Pass,63,16,79,J2EE ,Pass,51,15,66,J2EE AND SOFTWARE TESTING LABORATORY,Pass,80,14,94,PROJECT AND VIVA VOCE ,Pass,240,60,300
M1614612, College : 5256  -  RAMAKRISHNA VIVEKANAND BCA COLLEGE  TIDAGUNDI,DISTI,81.92,SOFTWARE PRACTICES AND TESTING ,Pass,55,16,71,BUSINESS INTELLIGENCE ,Pass,65,16,81,J2EE ,Pass,59,15,74,J2EE AND SOFTWARE TESTING LABORATORY,Pass,70,14,84,PROJECT AND VIVA VOCE ,Pass,237,56,293
M1614613, College : 5256  -  RAMAKRISHNA VIVEKANAND BCA COLLEGE  TIDAGUNDI,N.C.L,--   ,SOFTWARE PRACTICES AND TESTING ,Pass,38,18,56,BUSINESS INTELLIGENCE ,Pass,55,18,73,J2EE ,Pass,41,19,60,J2EE AND SOFTWARE TESTING LABORATORY,Pass,75,18,93,PROJECT AND VIVA VOCE ,Pass,240,60,300
M1614614, College : 5256  -  RAMAKRISHNA VIVEKANAND BCA COLLEGE  TIDAGUNDI,N.C.L,--   ,SOFTWARE PRACTICES AND TESTING ,Pass,41,10,51,BUSINESS INTELLIGENCE ,Pass,48,17,65,J2EE ,Pass,40,17,57,J2EE AND SOFTWARE TESTING LABORATORY,Pass,45,14,59,PROJECT AND VIVA VOCE ,Pass,237,55,292
M1614615, College : 5256  -  RAMAKRISHNA VIVEKANAND BCA COLLEGE  TIDAGUNDI,DISTI,74.62,SOFTWARE PRACTICES AND TESTING ,Pass,40,13,53,BUSINESS INTELLIGENCE ,Pass,70,15,85,J2EE ,Pass,47,17,64,J2EE AND SOFTWARE TESTING LABORATORY,Pass,70,14,84,PROJECT AND VIVA VOCE ,Pass,235,50,285
M1614616, College : 5256  -  RAMAKRISHNA VIVEKANAND BCA COLLEGE  TIDAGUNDI,DISTI,70.84,SOFTWARE PRACTICES AND TESTING ,Pass,44,15,59,BUSINESS INTELLIGENCE ,Pass,40,18,58,J2EE ,Pass,51,16,67,J2EE AND SOFTWARE TESTING LABORATORY,Pass,65,14,79,PROJECT AND VIVA VOCE ,Pass,233,56,289
M1614617, College : 5256  -  RAMAKRISHNA VIVEKANAND BCA COLLEGE  TIDAGUNDI,DISTI,79.57,SOFTWARE PRACTICES AND TESTING ,Pass,33,18,51,BUSINESS INTELLIGENCE ,Pass,35,19,54,J2EE ,Pass,49,18,67,J2EE AND SOFTWARE TESTING LABORATORY,Pass,78,17,95,PROJECT AND VIVA VOCE ,Pass,240,57,297
M1614619, College : 5256  -  RAMAKRISHNA VIVEKANAND BCA COLLEGE  TIDAGUNDI,DISTI,85.43,SOFTWARE PRACTICES AND TESTING ,Pass,53,20,73,BUSINESS INTELLIGENCE ,Pass,55,18,73,J2EE ,Pass,65,18,83,J2EE AND SOFTWARE TESTING LABORATORY,Pass,78,18,96,PROJECT AND VIVA VOCE ,Pass,240,58,298
M1614620, College : 5256  -  RAMAKRISHNA VIVEKANAND BCA COLLEGE  TIDAGUNDI,N.C.L,--   ,SOFTWARE PRACTICES AND TESTING ,Pass,47,18,65,BUSINESS INTELLIGENCE ,Pass,53,18,71,J2EE ,Pass,43,18,61,J2EE AND SOFTWARE TESTING LABORATORY,Pass,75,18,93,PROJECT AND VIVA VOCE ,Pass,238,59,297
M1614621, College : 5256  -  RAMAKRISHNA VIVEKANAND BCA COLLEGE  TIDAGUNDI,N.C.L,--   ,SOFTWARE PRACTICES AND TESTING ,Pass,43,16,59,BUSINESS INTELLIGENCE ,Pass,32,17,49,J2EE ,Pass,42,14,56,J2EE AND SOFTWARE TESTING LABORATORY,Pass,75,17,92,PROJECT AND VIVA VOCE ,Pass,237,56,293
M1614622, College : 5256  -  RAMAKRISHNA VIVEKANAND BCA COLLEGE  TIDAGUNDI,DISTI,75.11,SOFTWARE PRACTICES AND TESTING ,Pass,58,14,72,BUSINESS INTELLIGENCE ,Pass,52,16,68,J2EE ,Pass,52,15,67,J2EE AND SOFTWARE TESTING LABORATORY,Pass,75,15,90,PROJECT AND VIVA VOCE ,Pass,236,56,292
M1614623, College : 5256  -  RAMAKRISHNA VIVEKANAND BCA COLLEGE  TIDAGUNDI,N.C.L,--   ,SOFTWARE PRACTICES AND TESTING ,Pass,35,18,53,BUSINESS INTELLIGENCE ,Pass,38,18,56,J2EE ,Pass,43,18,61,J2EE AND SOFTWARE TESTING LABORATORY,Pass,80,16,96,PROJECT AND VIVA VOCE ,Pass,240,58,298
M1614624, College : 5256  -  RAMAKRISHNA VIVEKANAND BCA COLLEGE  TIDAGUNDI,DISTI,72.54,SOFTWARE PRACTICES AND TESTING ,Pass,39,17,56,BUSINESS INTELLIGENCE ,Pass,50,20,70,J2EE ,Pass,42,18,60,J2EE AND SOFTWARE TESTING LABORATORY,Pass,80,15,95,PROJECT AND VIVA VOCE ,Pass,236,55,291
M1614625, College : 5256  -  RAMAKRISHNA VIVEKANAND BCA COLLEGE  TIDAGUNDI,DISTI,81.68,SOFTWARE PRACTICES AND TESTING ,Pass,63,15,78,BUSINESS INTELLIGENCE ,Pass,45,18,63,J2EE ,Pass,47,17,64,J2EE AND SOFTWARE TESTING LABORATORY,Pass,80,14,94,PROJECT AND VIVA VOCE ,Pass,240,56,296
M1614627, College : 5256  -  RAMAKRISHNA VIVEKANAND BCA COLLEGE  TIDAGUNDI,N.C.L,--   ,SOFTWARE PRACTICES AND TESTING ,Pass,48,15,63,BUSINESS INTELLIGENCE ,Pass,39,15,54,J2EE ,Pass,36,14,50,J2EE AND SOFTWARE TESTING LABORATORY,Pass,70,14,84,PROJECT AND VIVA VOCE ,Pass,230,55,285
M1614630, College : 5256  -  RAMAKRISHNA VIVEKANAND BCA COLLEGE  TIDAGUNDI,FAIL,19.86,SOFTWARE PRACTICES AND TESTING ,Fail,0,10,10,BUSINESS INTELLIGENCE ,Fail,0,10,10,J2EE ,Fail,0,9,9,J2EE AND SOFTWARE TESTING LABORATORY,Pass,60,10,70,PROJECT AND VIVA VOCE ,Fail,Ab.,40,40
M1614631, College : 5256  -  RAMAKRISHNA VIVEKANAND BCA COLLEGE  TIDAGUNDI,N.C.L,--   ,SOFTWARE PRACTICES AND TESTING ,Pass,47,15,62,BUSINESS INTELLIGENCE ,Pass,38,16,54,J2EE ,Pass,43,15,58,J2EE AND SOFTWARE TESTING LABORATORY,Pass,75,14,89,PROJECT AND VIVA VOCE ,Pass,236,56,292
M1614632, College : 5256  -  RAMAKRISHNA VIVEKANAND BCA COLLEGE  TIDAGUNDI,N.C.L,--   ,SOFTWARE PRACTICES AND TESTING ,Pass,42,10,52,BUSINESS INTELLIGENCE ,Pass,42,15,57,J2EE ,Pass,43,15,58,J2EE AND SOFTWARE TESTING LABORATORY,Pass,75,14,89,PROJECT AND VIVA VOCE ,Pass,235,56,291
M1614633, College : 5256  -  RAMAKRISHNA VIVEKANAND BCA COLLEGE  TIDAGUNDI,FAIL,73,SOFTWARE PRACTICES AND TESTING ,Pass,33,12,45,BUSINESS INTELLIGENCE ,Fail,20,14,34,J2EE ,Pass,37,16,53,J2EE AND SOFTWARE TESTING LABORATORY,Pass,75,14,89,PROJECT AND VIVA VOCE ,Pass,235,55,290
M1614634, College : 5256  -  RAMAKRISHNA VIVEKANAND BCA COLLEGE  TIDAGUNDI,N.C.L,--   ,SOFTWARE PRACTICES AND TESTING ,Pass,38,10,48,BUSINESS INTELLIGENCE ,Pass,34,12,46,J2EE ,Pass,42,14,56,J2EE AND SOFTWARE TESTING LABORATORY,Pass,60,12,72,PROJECT AND VIVA VOCE ,Pass,225,51,276
M1614635, College : 5256  -  RAMAKRISHNA VIVEKANAND BCA COLLEGE  TIDAGUNDI,DISTI,80.97,SOFTWARE PRACTICES AND TESTING ,Pass,49,18,67,BUSINESS INTELLIGENCE ,Pass,42,20,62,J2EE ,Pass,51,20,71,J2EE AND SOFTWARE TESTING LABORATORY,Pass,80,18,98,PROJECT AND VIVA VOCE ,Pass,240,60,300
M1614636, College : 5256  -  RAMAKRISHNA VIVEKANAND BCA COLLEGE  TIDAGUNDI,N.C.L,--   ,SOFTWARE PRACTICES AND TESTING ,Pass,38,10,48,BUSINESS INTELLIGENCE ,Pass,34,16,50,J2EE ,Pass,32,15,47,J2EE AND SOFTWARE TESTING LABORATORY,Pass,68,14,82,PROJECT AND VIVA VOCE ,Pass,233,58,291
M1614637, College : 5256  -  RAMAKRISHNA VIVEKANAND BCA COLLEGE  TIDAGUNDI,N.C.L,--   ,SOFTWARE PRACTICES AND TESTING ,Pass,48,14,62,BUSINESS INTELLIGENCE ,Pass,41,17,58,J2EE ,Pass,35,15,50,J2EE AND SOFTWARE TESTING LABORATORY,Pass,75,14,89,PROJECT AND VIVA VOCE ,Pass,234,54,288
M1614638, College : 5256  -  RAMAKRISHNA VIVEKANAND BCA COLLEGE  TIDAGUNDI,FAIL,72.57,SOFTWARE PRACTICES AND TESTING ,Pass,49,10,59,BUSINESS INTELLIGENCE ,Pass,51,15,66,J2EE ,Fail,4,14,18,J2EE AND SOFTWARE TESTING LABORATORY,Pass,68,12,80,PROJECT AND VIVA VOCE ,Pass,232,53,285
M1614639, College : 5256  -  RAMAKRISHNA VIVEKANAND BCA COLLEGE  TIDAGUNDI,DISTI,84.11,SOFTWARE PRACTICES AND TESTING ,Pass,62,20,82,BUSINESS INTELLIGENCE ,Pass,64,20,84,J2EE ,Pass,56,20,76,J2EE AND SOFTWARE TESTING LABORATORY,Pass,80,18,98,PROJECT AND VIVA VOCE ,Pass,240,60,300
M1614640, College : 5256  -  RAMAKRISHNA VIVEKANAND BCA COLLEGE  TIDAGUNDI,N.C.L,--   ,SOFTWARE PRACTICES AND TESTING ,Pass,32,10,42,BUSINESS INTELLIGENCE ,Pass,44,15,59,J2EE ,Pass,34,14,48,J2EE AND SOFTWARE TESTING LABORATORY,Pass,68,12,80,PROJECT AND VIVA VOCE ,Pass,230,54,284
M1614641, College : 5256  -  RAMAKRISHNA VIVEKANAND BCA COLLEGE  TIDAGUNDI,N.C.L,--   ,SOFTWARE PRACTICES AND TESTING ,Pass,48,17,65,BUSINESS INTELLIGENCE ,Pass,52,15,67,J2EE ,Pass,34,14,48,J2EE AND SOFTWARE TESTING LABORATORY,Pass,74,17,91,PROJECT AND VIVA VOCE ,Pass,240,58,298
M1614642, College : 5256  -  RAMAKRISHNA VIVEKANAND BCA COLLEGE  TIDAGUNDI,N.C.L,--   ,SOFTWARE PRACTICES AND TESTING ,Pass,44,17,61,BUSINESS INTELLIGENCE ,Pass,58,17,75,J2EE ,Pass,34,18,52,J2EE AND SOFTWARE TESTING LABORATORY,Pass,75,18,93,PROJECT AND VIVA VOCE ,Pass,240,58,298
M1614643, College : 5256  -  RAMAKRISHNA VIVEKANAND BCA COLLEGE  TIDAGUNDI,N.C.L,--   ,SOFTWARE PRACTICES AND TESTING ,Pass,46,17,63,BUSINESS INTELLIGENCE ,Pass,62,18,80,J2EE ,Pass,39,18,57,J2EE AND SOFTWARE TESTING LABORATORY,Pass,75,17,92,PROJECT AND VIVA VOCE ,Pass,238,58,296
M1614644, College : 5256  -  RAMAKRISHNA VIVEKANAND BCA COLLEGE  TIDAGUNDI,DISTI,75.49,SOFTWARE PRACTICES AND TESTING ,Pass,49,16,65,BUSINESS INTELLIGENCE ,Pass,57,18,75,J2EE ,Pass,42,16,58,J2EE AND SOFTWARE TESTING LABORATORY,Pass,70,14,84,PROJECT AND VIVA VOCE ,Pass,240,57,297
M1614647, College : 5256  -  RAMAKRISHNA VIVEKANAND BCA COLLEGE  TIDAGUNDI,N.C.L,--   ,SOFTWARE PRACTICES AND TESTING ,Pass,50,15,65,BUSINESS INTELLIGENCE ,Pass,58,15,73,J2EE ,Pass,40,15,55,J2EE AND SOFTWARE TESTING LABORATORY,Pass,76,14,90,PROJECT AND VIVA VOCE ,Pass,240,56,296
M1614648, College : 5256  -  RAMAKRISHNA VIVEKANAND BCA COLLEGE  TIDAGUNDI,N.C.L,--   ,SOFTWARE PRACTICES AND TESTING ,Pass,43,13,56,BUSINESS INTELLIGENCE ,Pass,67,15,82,J2EE ,Pass,38,16,54,J2EE AND SOFTWARE TESTING LABORATORY,Pass,71,14,85,PROJECT AND VIVA VOCE ,Pass,234,52,286
M1614649, College : 5256  -  RAMAKRISHNA VIVEKANAND BCA COLLEGE  TIDAGUNDI,N.C.L,--   ,SOFTWARE PRACTICES AND TESTING ,Pass,36,8,44,BUSINESS INTELLIGENCE ,Pass,64,15,79,J2EE ,Pass,42,16,58,J2EE AND SOFTWARE TESTING LABORATORY,Pass,67,12,79,PROJECT AND VIVA VOCE ,Pass,235,54,289
M1614650, College : 5256  -  RAMAKRISHNA VIVEKANAND BCA COLLEGE  TIDAGUNDI,DISTI,70.95,SOFTWARE PRACTICES AND TESTING ,Pass,36,12,48,BUSINESS INTELLIGENCE ,Pass,55,14,69,J2EE ,Pass,33,16,49,J2EE AND SOFTWARE TESTING LABORATORY,Pass,67,13,80,PROJECT AND VIVA VOCE ,Pass,235,54,289
M1614651, College : 5256  -  RAMAKRISHNA VIVEKANAND BCA COLLEGE  TIDAGUNDI,FAIL,64.43,SOFTWARE PRACTICES AND TESTING ,Pass,34,15,49,BUSINESS INTELLIGENCE ,Pass,35,15,50,J2EE ,Fail,15,13,28,J2EE AND SOFTWARE TESTING LABORATORY,Pass,66,16,82,PROJECT AND VIVA VOCE ,Pass,190,52,242
M1614652, College : 5256  -  RAMAKRISHNA VIVEKANAND BCA COLLEGE  TIDAGUNDI,DISTI,81.3,SOFTWARE PRACTICES AND TESTING ,Pass,53,10,63,BUSINESS INTELLIGENCE ,Pass,60,16,76,J2EE ,Pass,50,16,66,J2EE AND SOFTWARE TESTING LABORATORY,Pass,75,14,89,PROJECT AND VIVA VOCE ,Pass,238,56,294
M1614653, College : 5256  -  RAMAKRISHNA VIVEKANAND BCA COLLEGE  TIDAGUNDI,DISTI,73.7,SOFTWARE PRACTICES AND TESTING ,Pass,43,12,55,BUSINESS INTELLIGENCE ,Pass,60,15,75,J2EE ,Pass,43,16,59,J2EE AND SOFTWARE TESTING LABORATORY,Pass,71,14,85,PROJECT AND VIVA VOCE ,Pass,236,56,292
M1614655, College : 5256  -  RAMAKRISHNA VIVEKANAND BCA COLLEGE  TIDAGUNDI,DISTI,77.92,SOFTWARE PRACTICES AND TESTING ,Pass,52,12,64,BUSINESS INTELLIGENCE ,Pass,62,20,82,J2EE ,Pass,46,17,63,J2EE AND SOFTWARE TESTING LABORATORY,Pass,68,14,82,PROJECT AND VIVA VOCE ,Pass,235,54,289
M1614657, College : 5256  -  RAMAKRISHNA VIVEKANAND BCA COLLEGE  TIDAGUNDI,N.C.L,--   ,SOFTWARE PRACTICES AND TESTING ,Pass,47,10,57,BUSINESS INTELLIGENCE ,Pass,63,14,77,J2EE ,Pass,45,14,59,J2EE AND SOFTWARE TESTING LABORATORY,Pass,66,12,78,PROJECT AND VIVA VOCE ,Pass,234,51,285
M1614658, College : 5256  -  RAMAKRISHNA VIVEKANAND BCA COLLEGE  TIDAGUNDI,FAIL,8.86,SOFTWARE PRACTICES AND TESTING ,Fail,Ab.,8,8,BUSINESS INTELLIGENCE ,Fail,Ab.,8,8,J2EE ,Fail,Ab.,8,8,J2EE AND SOFTWARE TESTING LABORATORY,Fail,Ab.,8,8,PROJECT AND VIVA VOCE ,Fail,Ab.,30,30
M1614659, College : 5256  -  RAMAKRISHNA VIVEKANAND BCA COLLEGE  TIDAGUNDI,FAIL,52.14,SOFTWARE PRACTICES AND TESTING ,Pass,33,14,47,BUSINESS INTELLIGENCE ,Pass,36,12,48,J2EE ,Fail,21,10,31,J2EE AND SOFTWARE TESTING LABORATORY,Pass,40,10,50,PROJECT AND VIVA VOCE ,Pass,145,44,189
M1614660, College : 5256  -  RAMAKRISHNA VIVEKANAND BCA COLLEGE  TIDAGUNDI,N.C.L,--   ,SOFTWARE PRACTICES AND TESTING ,Pass,47,18,65,BUSINESS INTELLIGENCE ,Pass,46,15,61,J2EE ,Pass,36,20,56,J2EE AND SOFTWARE TESTING LABORATORY,Pass,76,18,94,PROJECT AND VIVA VOCE ,Pass,238,58,296
M1614661, College : 5256  -  RAMAKRISHNA VIVEKANAND BCA COLLEGE  TIDAGUNDI,DISTI,77.81,SOFTWARE PRACTICES AND TESTING ,Pass,43,18,61,BUSINESS INTELLIGENCE ,Pass,62,17,79,J2EE ,Pass,47,20,67,J2EE AND SOFTWARE TESTING LABORATORY,Pass,78,18,96,PROJECT AND VIVA VOCE ,Pass,240,58,298
M1614662, College : 5256  -  RAMAKRISHNA VIVEKANAND BCA COLLEGE  TIDAGUNDI,DISTI,79.35,SOFTWARE PRACTICES AND TESTING ,Pass,56,18,74,BUSINESS INTELLIGENCE ,Pass,65,17,82,J2EE ,Pass,52,19,71,J2EE AND SOFTWARE TESTING LABORATORY,Pass,71,18,89,PROJECT AND VIVA VOCE ,Pass,235,57,292
M1614663, College : 5256  -  RAMAKRISHNA VIVEKANAND BCA COLLEGE  TIDAGUNDI,N.C.L,--   ,SOFTWARE PRACTICES AND TESTING ,Pass,32,14,46,BUSINESS INTELLIGENCE ,Pass,52,16,68,J2EE ,Pass,39,14,53,J2EE AND SOFTWARE TESTING LABORATORY,Pass,65,14,79,PROJECT AND VIVA VOCE ,Pass,230,54,284
M1614664, College : 5256  -  RAMAKRISHNA VIVEKANAND BCA COLLEGE  TIDAGUNDI,1ST C,65.49,SOFTWARE PRACTICES AND TESTING ,Pass,32,13,45,BUSINESS INTELLIGENCE ,Pass,43,16,59,J2EE ,Pass,32,14,46,J2EE AND SOFTWARE TESTING LABORATORY,Pass,68,14,82,PROJECT AND VIVA VOCE ,Pass,230,51,281
M1614665, College : 5256  -  RAMAKRISHNA VIVEKANAND BCA COLLEGE  TIDAGUNDI,DISTI,77.38,SOFTWARE PRACTICES AND TESTING ,Pass,47,17,64,BUSINESS INTELLIGENCE ,Pass,67,18,85,J2EE ,Pass,43,20,63,J2EE AND SOFTWARE TESTING LABORATORY,Pass,72,18,90,PROJECT AND VIVA VOCE ,Pass,235,60,295
M1614666, College : 5256  -  RAMAKRISHNA VIVEKANAND BCA COLLEGE  TIDAGUNDI,DISTI,85.73,SOFTWARE PRACTICES AND TESTING ,Pass,55,20,75,BUSINESS INTELLIGENCE ,Pass,68,19,87,J2EE ,Pass,53,20,73,J2EE AND SOFTWARE TESTING LABORATORY,Pass,80,20,100,PROJECT AND VIVA VOCE ,Pass,240,60,300
M1614667, College : 5256  -  RAMAKRISHNA VIVEKANAND BCA COLLEGE  TIDAGUNDI,DISTI,73.32,SOFTWARE PRACTICES AND TESTING ,Pass,47,14,61,BUSINESS INTELLIGENCE ,Pass,65,14,79,J2EE ,Pass,32,18,50,J2EE AND SOFTWARE TESTING LABORATORY,Pass,72,14,86,PROJECT AND VIVA VOCE ,Pass,238,58,296
M1614668, College : 5256  -  RAMAKRISHNA VIVEKANAND BCA COLLEGE  TIDAGUNDI,DISTI,71.65,SOFTWARE PRACTICES AND TESTING ,Pass,50,14,64,BUSINESS INTELLIGENCE ,Pass,60,19,79,J2EE ,Pass,34,17,51,J2EE AND SOFTWARE TESTING LABORATORY,Pass,77,16,93,PROJECT AND VIVA VOCE ,Pass,240,60,300
M1614669, College : 5256  -  RAMAKRISHNA VIVEKANAND BCA COLLEGE  TIDAGUNDI,DISTI,72.65,SOFTWARE PRACTICES AND TESTING ,Pass,47,8,55,BUSINESS INTELLIGENCE ,Pass,51,16,67,J2EE ,Pass,34,14,48,J2EE AND SOFTWARE TESTING LABORATORY,Pass,70,12,82,PROJECT AND VIVA VOCE ,Pass,240,55,295
M1614670, College : 5256  -  RAMAKRISHNA VIVEKANAND BCA COLLEGE  TIDAGUNDI,N.C.L,--   ,SOFTWARE PRACTICES AND TESTING ,Pass,52,16,68,BUSINESS INTELLIGENCE ,Pass,66,15,81,J2EE ,Pass,53,15,68,J2EE AND SOFTWARE TESTING LABORATORY,Pass,68,16,84,PROJECT AND VIVA VOCE ,Pass,238,56,294
M1614671, College : 5256  -  RAMAKRISHNA VIVEKANAND BCA COLLEGE  TIDAGUNDI,DISTI,80.92,SOFTWARE PRACTICES AND TESTING ,Pass,58,17,75,BUSINESS INTELLIGENCE ,Pass,69,18,87,J2EE ,Pass,66,16,82,J2EE AND SOFTWARE TESTING LABORATORY,Pass,78,14,92,PROJECT AND VIVA VOCE ,Pass,240,56,296
M1614672, College : 5256  -  RAMAKRISHNA VIVEKANAND BCA COLLEGE  TIDAGUNDI,DISTI,71.54,SOFTWARE PRACTICES AND TESTING ,Pass,46,14,60,BUSINESS INTELLIGENCE ,Pass,70,17,87,J2EE ,Pass,37,16,53,J2EE AND SOFTWARE TESTING LABORATORY,Pass,68,14,82,PROJECT AND VIVA VOCE ,Pass,235,56,291
M1614673, College : 5256  -  RAMAKRISHNA VIVEKANAND BCA COLLEGE  TIDAGUNDI,DISTI,82.54,SOFTWARE PRACTICES AND TESTING ,Pass,59,15,74,BUSINESS INTELLIGENCE ,Pass,71,17,88,J2EE ,Pass,34,16,50,J2EE AND SOFTWARE TESTING LABORATORY,Pass,80,18,98,PROJECT AND VIVA VOCE ,Pass,240,60,300
M1614675, College : 5256  -  RAMAKRISHNA VIVEKANAND BCA COLLEGE  TIDAGUNDI,N.C.L,--   ,SOFTWARE PRACTICES AND TESTING ,Pass,33,15,48,BUSINESS INTELLIGENCE ,Pass,57,15,72,J2EE ,Pass,32,14,46,J2EE AND SOFTWARE TESTING LABORATORY,Pass,68,14,82,PROJECT AND VIVA VOCE ,Pass,234,54,288
M1614677, College : 5256  -  RAMAKRISHNA VIVEKANAND BCA COLLEGE  TIDAGUNDI,DISTI,72.27,SOFTWARE PRACTICES AND TESTING ,Pass,35,15,50,BUSINESS INTELLIGENCE ,Pass,74,14,88,J2EE ,Pass,38,14,52,J2EE AND SOFTWARE TESTING LABORATORY,Pass,73,14,87,PROJECT AND VIVA VOCE ,Pass,240,58,298
M1614678, College : 5256  -  RAMAKRISHNA VIVEKANAND BCA COLLEGE  TIDAGUNDI,DISTI,77.46,SOFTWARE PRACTICES AND TESTING ,Pass,67,18,85,BUSINESS INTELLIGENCE ,Pass,76,16,92,J2EE ,Pass,45,18,63,J2EE AND SOFTWARE TESTING LABORATORY,Pass,78,18,96,PROJECT AND VIVA VOCE ,Pass,240,60,300
M1614679, College : 5256  -  RAMAKRISHNA VIVEKANAND BCA COLLEGE  TIDAGUNDI,N.C.L,--   ,SOFTWARE PRACTICES AND TESTING ,Pass,32,14,46,BUSINESS INTELLIGENCE ,Pass,41,15,56,J2EE ,Pass,32,18,50,J2EE AND SOFTWARE TESTING LABORATORY,Pass,66,14,80,PROJECT AND VIVA VOCE ,Pass,232,54,286
M1614680, College : 5256  -  RAMAKRISHNA VIVEKANAND BCA COLLEGE  TIDAGUNDI,1ST C,63.95,SOFTWARE PRACTICES AND TESTING ,Pass,36,12,48,BUSINESS INTELLIGENCE ,Pass,46,14,60,J2EE ,Pass,36,14,50,J2EE AND SOFTWARE TESTING LABORATORY,Pass,71,14,85,PROJECT AND VIVA VOCE ,Pass,233,56,289
M1614682, College : 5256  -  RAMAKRISHNA VIVEKANAND BCA COLLEGE  TIDAGUNDI,N.C.L,--   ,SOFTWARE PRACTICES AND TESTING ,Pass,33,16,49,BUSINESS INTELLIGENCE ,Pass,44,16,60,J2EE ,Pass,33,18,51,J2EE AND SOFTWARE TESTING LABORATORY,Pass,73,17,90,PROJECT AND VIVA VOCE ,Pass,236,56,292
M1614684, College : 5256  -  RAMAKRISHNA VIVEKANAND BCA COLLEGE  TIDAGUNDI,N.C.L,--   ,SOFTWARE PRACTICES AND TESTING ,Pass,34,14,48,BUSINESS INTELLIGENCE ,Pass,57,15,72,J2EE ,Pass,41,14,55,J2EE AND SOFTWARE TESTING LABORATORY,Pass,70,14,84,PROJECT AND VIVA VOCE ,Pass,237,57,294
M1614685, College : 5256  -  RAMAKRISHNA VIVEKANAND BCA COLLEGE  TIDAGUNDI,N.C.L,--   ,SOFTWARE PRACTICES AND TESTING ,Pass,35,8,43,BUSINESS INTELLIGENCE ,Pass,52,14,66,J2EE ,Pass,32,14,46,J2EE AND SOFTWARE TESTING LABORATORY,Pass,60,10,70,PROJECT AND VIVA VOCE ,Pass,230,30,260
M1614686, College : 5256  -  RAMAKRISHNA VIVEKANAND BCA COLLEGE  TIDAGUNDI,DISTI,77.7,SOFTWARE PRACTICES AND TESTING ,Pass,64,20,84,BUSINESS INTELLIGENCE ,Pass,65,17,82,J2EE ,Pass,59,20,79,J2EE AND SOFTWARE TESTING LABORATORY,Pass,80,20,100,PROJECT AND VIVA VOCE ,Pass,240,60,300
M1614687, College : 5256  -  RAMAKRISHNA VIVEKANAND BCA COLLEGE  TIDAGUNDI,N.C.L,--   ,SOFTWARE PRACTICES AND TESTING ,Pass,37,8,45,BUSINESS INTELLIGENCE ,Pass,53,14,67,J2EE ,Pass,48,14,62,J2EE AND SOFTWARE TESTING LABORATORY,Pass,64,12,76,PROJECT AND VIVA VOCE ,Pass,230,50,280
M1614688, College : 5256  -  RAMAKRISHNA VIVEKANAND BCA COLLEGE  TIDAGUNDI,DISTI,80.11,SOFTWARE PRACTICES AND TESTING ,Pass,53,16,69,BUSINESS INTELLIGENCE ,Pass,70,17,87,J2EE ,Pass,59,20,79,J2EE AND SOFTWARE TESTING LABORATORY,Pass,74,18,92,PROJECT AND VIVA VOCE ,Pass,232,58,290
M1614689, College : 5256  -  RAMAKRISHNA VIVEKANAND BCA COLLEGE  TIDAGUNDI,DISTI,79.14,SOFTWARE PRACTICES AND TESTING ,Pass,51,16,67,BUSINESS INTELLIGENCE ,Pass,72,19,91,J2EE ,Pass,51,19,70,J2EE AND SOFTWARE TESTING LABORATORY,Pass,76,16,92,PROJECT AND VIVA VOCE ,Pass,240,60,300
M1614690, College : 5256  -  RAMAKRISHNA VIVEKANAND BCA COLLEGE  TIDAGUNDI,DISTI,75.43,SOFTWARE PRACTICES AND TESTING ,Pass,40,16,56,BUSINESS INTELLIGENCE ,Pass,59,19,78,J2EE ,Pass,45,19,64,J2EE AND SOFTWARE TESTING LABORATORY,Pass,76,15,91,PROJECT AND VIVA VOCE ,Pass,236,60,296
M1614691, College : 5256  -  RAMAKRISHNA VIVEKANAND BCA COLLEGE  TIDAGUNDI,1ST C,65.65,SOFTWARE PRACTICES AND TESTING ,Pass,33,8,41,BUSINESS INTELLIGENCE ,Pass,46,14,60,J2EE ,Pass,37,14,51,J2EE AND SOFTWARE TESTING LABORATORY,Pass,65,12,77,PROJECT AND VIVA VOCE ,Pass,232,52,284
M1614693, College : 5256  -  RAMAKRISHNA VIVEKANAND BCA COLLEGE  TIDAGUNDI,1ST C,66.76,SOFTWARE PRACTICES AND TESTING ,Pass,32,16,48,BUSINESS INTELLIGENCE ,Pass,60,16,76,J2EE ,Pass,41,16,57,J2EE AND SOFTWARE TESTING LABORATORY,Pass,73,17,90,PROJECT AND VIVA VOCE ,Pass,238,58,296
M1614694, College : 5256  -  RAMAKRISHNA VIVEKANAND BCA COLLEGE  TIDAGUNDI,N.C.L,--   ,SOFTWARE PRACTICES AND TESTING ,Pass,32,14,46,BUSINESS INTELLIGENCE ,Pass,45,16,61,J2EE ,Pass,32,14,46,J2EE AND SOFTWARE TESTING LABORATORY,Pass,75,14,89,PROJECT AND VIVA VOCE ,Pass,234,55,289
M1614695, College : 5256  -  RAMAKRISHNA VIVEKANAND BCA COLLEGE  TIDAGUNDI,1ST C,68.35,SOFTWARE PRACTICES AND TESTING ,Pass,37,12,49,BUSINESS INTELLIGENCE ,Pass,51,14,65,J2EE ,Pass,46,14,60,J2EE AND SOFTWARE TESTING LABORATORY,Pass,40,14,54,PROJECT AND VIVA VOCE ,Pass,230,54,284
M1614696, College : 5256  -  RAMAKRISHNA VIVEKANAND BCA COLLEGE  TIDAGUNDI,DISTI,72.89,SOFTWARE PRACTICES AND TESTING ,Pass,36,18,54,BUSINESS INTELLIGENCE ,Pass,49,16,65,J2EE ,Pass,56,16,72,J2EE AND SOFTWARE TESTING LABORATORY,Pass,72,14,86,PROJECT AND VIVA VOCE ,Pass,235,58,293
M1614697, College : 5256  -  RAMAKRISHNA VIVEKANAND BCA COLLEGE  TIDAGUNDI,N.C.L,--   ,SOFTWARE PRACTICES AND TESTING ,Pass,34,8,42,BUSINESS INTELLIGENCE ,Pass,42,12,54,J2EE ,Pass,40,12,52,J2EE AND SOFTWARE TESTING LABORATORY,Pass,40,10,50,PROJECT AND VIVA VOCE ,Pass,230,58,288
M1614698, College : 5256  -  RAMAKRISHNA VIVEKANAND BCA COLLEGE  TIDAGUNDI,N.C.L,--   ,SOFTWARE PRACTICES AND TESTING ,Pass,51,12,63,BUSINESS INTELLIGENCE ,Pass,53,14,67,J2EE ,Pass,45,14,59,J2EE AND SOFTWARE TESTING LABORATORY,Pass,70,14,84,PROJECT AND VIVA VOCE ,Pass,232,54,286
M1614699, College : 5256  -  RAMAKRISHNA VIVEKANAND BCA COLLEGE  TIDAGUNDI,DISTI,70.62,SOFTWARE PRACTICES AND TESTING ,Pass,37,17,54,BUSINESS INTELLIGENCE ,Pass,51,20,71,J2EE ,Pass,52,18,70,J2EE AND SOFTWARE TESTING LABORATORY,Pass,70,18,88,PROJECT AND VIVA VOCE ,Pass,235,58,293
M1614700, College : 5256  -  RAMAKRISHNA VIVEKANAND BCA COLLEGE  TIDAGUNDI,DISTI,89.68,SOFTWARE PRACTICES AND TESTING ,Pass,68,20,88,BUSINESS INTELLIGENCE ,Pass,74,20,94,J2EE ,Pass,55,20,75,J2EE AND SOFTWARE TESTING LABORATORY,Pass,80,20,100,PROJECT AND VIVA VOCE ,Pass,240,60,300
M1614701, College : 5256  -  RAMAKRISHNA VIVEKANAND BCA COLLEGE  TIDAGUNDI,DISTI,86.41,SOFTWARE PRACTICES AND TESTING ,Pass,53,20,73,BUSINESS INTELLIGENCE ,Pass,70,20,90,J2EE ,Pass,59,20,79,J2EE AND SOFTWARE TESTING LABORATORY,Pass,80,20,100,PROJECT AND VIVA VOCE ,Pass,240,60,300
M1614702, College : 5256  -  RAMAKRISHNA VIVEKANAND BCA COLLEGE  TIDAGUNDI,DISTI,91.35,SOFTWARE PRACTICES AND TESTING ,Pass,68,20,88,BUSINESS INTELLIGENCE ,Pass,76,20,96,J2EE ,Pass,60,20,80,J2EE AND SOFTWARE TESTING LABORATORY,Pass,78,20,98,PROJECT AND VIVA VOCE ,Pass,240,60,300
M1614704, College : 5256  -  RAMAKRISHNA VIVEKANAND BCA COLLEGE  TIDAGUNDI,N.C.L,--   ,SOFTWARE PRACTICES AND TESTING ,Pass,32,14,46,BUSINESS INTELLIGENCE ,Pass,45,14,59,J2EE ,Pass,32,14,46,J2EE AND SOFTWARE TESTING LABORATORY,Pass,68,14,82,PROJECT AND VIVA VOCE ,Pass,234,56,290
M1614705, College : 5256  -  RAMAKRISHNA VIVEKANAND BCA COLLEGE  TIDAGUNDI,FAIL,69.43,SOFTWARE PRACTICES AND TESTING ,Pass,32,15,47,BUSINESS INTELLIGENCE ,Fail,19,15,34,J2EE ,Fail,19,14,33,J2EE AND SOFTWARE TESTING LABORATORY,Pass,70,14,84,PROJECT AND VIVA VOCE ,Pass,232,56,288
M1614706, College : 5256  -  RAMAKRISHNA VIVEKANAND BCA COLLEGE  TIDAGUNDI,FAIL,71.14,SOFTWARE PRACTICES AND TESTING ,Pass,32,10,42,BUSINESS INTELLIGENCE ,Fail,22,14,36,J2EE ,Pass,32,14,46,J2EE AND SOFTWARE TESTING LABORATORY,Pass,70,12,82,PROJECT AND VIVA VOCE ,Pass,236,56,292
M1614707, College : 5256  -  RAMAKRISHNA VIVEKANAND BCA COLLEGE  TIDAGUNDI,1ST C,67.57,SOFTWARE PRACTICES AND TESTING ,Pass,32,13,45,BUSINESS INTELLIGENCE ,Pass,37,14,51,J2EE ,Pass,35,14,49,J2EE AND SOFTWARE TESTING LABORATORY,Pass,70,14,84,PROJECT AND VIVA VOCE ,Pass,234,56,290
M1614708, College : 5256  -  RAMAKRISHNA VIVEKANAND BCA COLLEGE  TIDAGUNDI,N.C.L,--   ,SOFTWARE PRACTICES AND TESTING ,Pass,32,12,44,BUSINESS INTELLIGENCE ,Pass,40,16,56,J2EE ,Pass,33,14,47,J2EE AND SOFTWARE TESTING LABORATORY,Pass,72,14,86,PROJECT AND VIVA VOCE ,Pass,236,56,292
M1614709, College : 5256  -  RAMAKRISHNA VIVEKANAND BCA COLLEGE  TIDAGUNDI,FAIL,73.57,SOFTWARE PRACTICES AND TESTING ,Fail,21,17,38,BUSINESS INTELLIGENCE ,Pass,35,19,54,J2EE ,Fail,19,18,37,J2EE AND SOFTWARE TESTING LABORATORY,Pass,74,18,92,PROJECT AND VIVA VOCE ,Pass,236,58,294
M1614710, College : 5256  -  RAMAKRISHNA VIVEKANAND BCA COLLEGE  TIDAGUNDI,DISTI,82.19,SOFTWARE PRACTICES AND TESTING ,Pass,48,20,68,BUSINESS INTELLIGENCE ,Pass,63,18,81,J2EE ,Pass,32,20,52,J2EE AND SOFTWARE TESTING LABORATORY,Pass,80,20,100,PROJECT AND VIVA VOCE ,Pass,240,60,300
M1614711, College : 5256  -  RAMAKRISHNA VIVEKANAND BCA COLLEGE  TIDAGUNDI,DISTI,76.43,SOFTWARE PRACTICES AND TESTING ,Pass,32,16,48,BUSINESS INTELLIGENCE ,Pass,51,16,67,J2EE ,Pass,32,18,50,J2EE AND SOFTWARE TESTING LABORATORY,Pass,76,16,92,PROJECT AND VIVA VOCE ,Pass,240,60,300
M1614712, College : 5256  -  RAMAKRISHNA VIVEKANAND BCA COLLEGE  TIDAGUNDI,N.C.L,--   ,SOFTWARE PRACTICES AND TESTING ,Pass,34,16,50,BUSINESS INTELLIGENCE ,Pass,41,17,58,J2EE ,Pass,32,16,48,J2EE AND SOFTWARE TESTING LABORATORY,Pass,71,18,89,PROJECT AND VIVA VOCE ,Pass,238,58,296
M1614713, College : 5256  -  RAMAKRISHNA VIVEKANAND BCA COLLEGE  TIDAGUNDI,FAIL,74.43,SOFTWARE PRACTICES AND TESTING ,Fail,19,15,34,BUSINESS INTELLIGENCE ,Pass,49,16,65,J2EE ,Pass,34,16,50,J2EE AND SOFTWARE TESTING LABORATORY,Pass,70,14,84,PROJECT AND VIVA VOCE ,Pass,232,56,288
M1614714, College : 5256  -  RAMAKRISHNA VIVEKANAND BCA COLLEGE  TIDAGUNDI,N.C.L,--   ,SOFTWARE PRACTICES AND TESTING ,Pass,32,18,50,BUSINESS INTELLIGENCE ,Pass,45,19,64,J2EE ,Pass,32,19,51,J2EE AND SOFTWARE TESTING LABORATORY,Pass,80,17,97,PROJECT AND VIVA VOCE ,Pass,240,60,300
M1614715, College : 5256  -  RAMAKRISHNA VIVEKANAND BCA COLLEGE  TIDAGUNDI,N.C.L,--   ,SOFTWARE PRACTICES AND TESTING ,Pass,32,16,48,BUSINESS INTELLIGENCE ,Pass,38,18,56,J2EE ,Pass,34,18,52,J2EE AND SOFTWARE TESTING LABORATORY,Pass,72,17,89,PROJECT AND VIVA VOCE ,Pass,240,60,300
M1614716, College : 5256  -  RAMAKRISHNA VIVEKANAND BCA COLLEGE  TIDAGUNDI,DISTI,77.54,SOFTWARE PRACTICES AND TESTING ,Pass,33,16,49,BUSINESS INTELLIGENCE ,Pass,47,17,64,J2EE ,Pass,37,18,55,J2EE AND SOFTWARE TESTING LABORATORY,Pass,72,18,90,PROJECT AND VIVA VOCE ,Pass,238,58,296
M1614717, College : 5262  -  SRI SANGAMESHWAR ARTS & COMMERCE COLLEGE  CHADACHAN,N.C.L,--   ,SOFTWARE PRACTICES AND TESTING ,Pass,51,14,65,BUSINESS INTELLIGENCE ,Pass,32,18,50,J2EE ,Pass,44,16,60,J2EE AND SOFTWARE TESTING LABORATORY,Pass,70,14,84,PROJECT AND VIVA VOCE ,Pass,237,56,293
M1614718, College : 5262  -  SRI SANGAMESHWAR ARTS & COMMERCE COLLEGE  CHADACHAN,N.C.L,--   ,SOFTWARE PRACTICES AND TESTING ,Pass,37,12,49,BUSINESS INTELLIGENCE ,Pass,34,12,46,J2EE ,Pass,32,10,42,J2EE AND SOFTWARE TESTING LABORATORY,Pass,40,10,50,PROJECT AND VIVA VOCE ,Pass,170,45,215
M1614802, College : 5262  -  SRI SANGAMESHWAR ARTS & COMMERCE COLLEGE  CHADACHAN,N.C.L,--   ,SOFTWARE PRACTICES AND TESTING ,Pass,32,18,50,BUSINESS INTELLIGENCE ,Pass,55,16,71,J2EE ,Pass,54,17,71,J2EE AND SOFTWARE TESTING LABORATORY,Pass,60,18,78,PROJECT AND VIVA VOCE ,Pass,210,51,261
M1614804, College : 5262  -  SRI SANGAMESHWAR ARTS & COMMERCE COLLEGE  CHADACHAN,DISTI,72.76,SOFTWARE PRACTICES AND TESTING ,Pass,53,17,70,BUSINESS INTELLIGENCE ,Pass,59,17,76,J2EE ,Pass,58,18,76,J2EE AND SOFTWARE TESTING LABORATORY,Pass,64,17,81,PROJECT AND VIVA VOCE ,Pass,215,54,269
M1615001, College : 5285  -  VEDANT B.C.A. AND B.COM. COLLEGE  VIJAYAPURA,DISTI,76.84,SOFTWARE PRACTICES AND TESTING ,Pass,42,18,60,BUSINESS INTELLIGENCE ,Pass,67,20,87,J2EE ,Pass,44,20,64,J2EE AND SOFTWARE TESTING LABORATORY,Pass,77,20,97,PROJECT AND VIVA VOCE ,Pass,235,57,292
M1615002, College : 5285  -  VEDANT B.C.A. AND B.COM. COLLEGE  VIJAYAPURA,N.C.L,--   ,SOFTWARE PRACTICES AND TESTING ,Pass,35,8,43,BUSINESS INTELLIGENCE ,Pass,50,18,68,J2EE ,Pass,35,13,48,J2EE AND SOFTWARE TESTING LABORATORY,Pass,40,15,55,PROJECT AND VIVA VOCE ,Pass,217,43,260
M1615003, College : 5285  -  VEDANT B.C.A. AND B.COM. COLLEGE  VIJAYAPURA,N.C.L,--   ,SOFTWARE PRACTICES AND TESTING ,Pass,51,11,62,BUSINESS INTELLIGENCE ,Pass,50,19,69,J2EE ,Pass,40,17,57,J2EE AND SOFTWARE TESTING LABORATORY,Pass,70,17,87,PROJECT AND VIVA VOCE ,Pass,230,57,287
M1615004, College : 5285  -  VEDANT B.C.A. AND B.COM. COLLEGE  VIJAYAPURA,DISTI,71.54,SOFTWARE PRACTICES AND TESTING ,Pass,58,11,69,BUSINESS INTELLIGENCE ,Pass,51,18,69,J2EE ,Pass,42,15,57,J2EE AND SOFTWARE TESTING LABORATORY,Pass,72,16,88,PROJECT AND VIVA VOCE ,Pass,217,43,260
M1615005, College : 5285  -  VEDANT B.C.A. AND B.COM. COLLEGE  VIJAYAPURA,DISTI,74.05,SOFTWARE PRACTICES AND TESTING ,Pass,60,13,73,BUSINESS INTELLIGENCE ,Pass,58,15,73,J2EE ,Pass,52,17,69,J2EE AND SOFTWARE TESTING LABORATORY,Pass,70,18,88,PROJECT AND VIVA VOCE ,Pass,210,54,264
M1615006, College : 5285  -  VEDANT B.C.A. AND B.COM. COLLEGE  VIJAYAPURA,N.C.L,--   ,SOFTWARE PRACTICES AND TESTING ,Pass,41,8,49,BUSINESS INTELLIGENCE ,Pass,53,18,71,J2EE ,Pass,38,15,53,J2EE AND SOFTWARE TESTING LABORATORY,Pass,70,12,82,PROJECT AND VIVA VOCE ,Pass,235,53,288
M1615007, College : 5285  -  VEDANT B.C.A. AND B.COM. COLLEGE  VIJAYAPURA,DISTI,79.05,SOFTWARE PRACTICES AND TESTING ,Pass,63,19,82,BUSINESS INTELLIGENCE ,Pass,68,20,88,J2EE ,Pass,47,18,65,J2EE AND SOFTWARE TESTING LABORATORY,Pass,80,18,98,PROJECT AND VIVA VOCE ,Pass,237,57,294
M1615008, College : 5285  -  VEDANT B.C.A. AND B.COM. COLLEGE  VIJAYAPURA,N.C.L,--   ,SOFTWARE PRACTICES AND TESTING ,Pass,51,8,59,BUSINESS INTELLIGENCE ,Pass,62,9,71,J2EE ,Pass,57,8,65,J2EE AND SOFTWARE TESTING LABORATORY,Pass,40,8,48,PROJECT AND VIVA VOCE ,Pass,175,35,210
M1615009, College : 5285  -  VEDANT B.C.A. AND B.COM. COLLEGE  VIJAYAPURA,DISTI,76.38,SOFTWARE PRACTICES AND TESTING ,Pass,66,18,84,BUSINESS INTELLIGENCE ,Pass,72,20,92,J2EE ,Pass,61,19,80,J2EE AND SOFTWARE TESTING LABORATORY,Pass,80,18,98,PROJECT AND VIVA VOCE ,Pass,238,58,296
M1615010, College : 5285  -  VEDANT B.C.A. AND B.COM. COLLEGE  VIJAYAPURA,N.C.L,--   ,SOFTWARE PRACTICES AND TESTING ,Pass,35,8,43,BUSINESS INTELLIGENCE ,Pass,38,18,56,J2EE ,Pass,36,14,50,J2EE AND SOFTWARE TESTING LABORATORY,Pass,45,12,57,PROJECT AND VIVA VOCE ,Pass,190,43,233
M1615011, College : 5285  -  VEDANT B.C.A. AND B.COM. COLLEGE  VIJAYAPURA,DISTI,85.62,SOFTWARE PRACTICES AND TESTING ,Pass,66,20,86,BUSINESS INTELLIGENCE ,Pass,71,20,91,J2EE ,Pass,61,20,81,J2EE AND SOFTWARE TESTING LABORATORY,Pass,80,20,100,PROJECT AND VIVA VOCE ,Pass,239,60,299
M1615012, College : 5285  -  VEDANT B.C.A. AND B.COM. COLLEGE  VIJAYAPURA,N.C.L,--   ,SOFTWARE PRACTICES AND TESTING ,Pass,51,13,64,BUSINESS INTELLIGENCE ,Pass,50,18,68,J2EE ,Pass,48,15,63,J2EE AND SOFTWARE TESTING LABORATORY,Pass,70,17,87,PROJECT AND VIVA VOCE ,Pass,228,53,281
M1615013, College : 5285  -  VEDANT B.C.A. AND B.COM. COLLEGE  VIJAYAPURA,N.C.L,--   ,SOFTWARE PRACTICES AND TESTING ,Pass,46,8,54,BUSINESS INTELLIGENCE ,Pass,60,9,69,J2EE ,Pass,52,8,60,J2EE AND SOFTWARE TESTING LABORATORY,Pass,60,8,68,PROJECT AND VIVA VOCE ,Pass,190,35,225
M1615014, College : 5285  -  VEDANT B.C.A. AND B.COM. COLLEGE  VIJAYAPURA,DISTI,78.68,SOFTWARE PRACTICES AND TESTING ,Pass,57,10,67,BUSINESS INTELLIGENCE ,Pass,69,20,89,J2EE ,Pass,59,20,79,J2EE AND SOFTWARE TESTING LABORATORY,Pass,80,20,100,PROJECT AND VIVA VOCE ,Pass,238,59,297
M1615016, College : 5285  -  VEDANT B.C.A. AND B.COM. COLLEGE  VIJAYAPURA,DISTI,73.86,SOFTWARE PRACTICES AND TESTING ,Pass,64,13,77,BUSINESS INTELLIGENCE ,Pass,65,16,81,J2EE ,Pass,63,17,80,J2EE AND SOFTWARE TESTING LABORATORY,Pass,74,19,93,PROJECT AND VIVA VOCE ,Pass,234,55,289
M1615017, College : 5285  -  VEDANT B.C.A. AND B.COM. COLLEGE  VIJAYAPURA,N.C.L,--   ,SOFTWARE PRACTICES AND TESTING ,Pass,42,8,50,BUSINESS INTELLIGENCE ,Pass,50,18,68,J2EE ,Pass,56,11,67,J2EE AND SOFTWARE TESTING LABORATORY,Pass,60,16,76,PROJECT AND VIVA VOCE ,Pass,190,50,240
M1615019, College : 5285  -  VEDANT B.C.A. AND B.COM. COLLEGE  VIJAYAPURA,N.C.L,--   ,SOFTWARE PRACTICES AND TESTING ,Pass,34,8,42,BUSINESS INTELLIGENCE ,Pass,37,18,55,J2EE ,Pass,36,8,44,J2EE AND SOFTWARE TESTING LABORATORY,Pass,55,15,70,PROJECT AND VIVA VOCE ,Pass,210,50,260
M1615020, College : 5285  -  VEDANT B.C.A. AND B.COM. COLLEGE  VIJAYAPURA,N.C.L,--   ,SOFTWARE PRACTICES AND TESTING ,Pass,50,9,59,BUSINESS INTELLIGENCE ,Pass,48,17,65,J2EE ,Pass,49,12,61,J2EE AND SOFTWARE TESTING LABORATORY,Pass,72,15,87,PROJECT AND VIVA VOCE ,Pass,203,52,255
M1615023, College : 5285  -  VEDANT B.C.A. AND B.COM. COLLEGE  VIJAYAPURA,DISTI,87.16,SOFTWARE PRACTICES AND TESTING ,Pass,51,15,66,BUSINESS INTELLIGENCE ,Pass,72,20,92,J2EE ,Pass,66,20,86,J2EE AND SOFTWARE TESTING LABORATORY,Pass,77,17,94,PROJECT AND VIVA VOCE ,Pass,230,59,289
M1615027, College : 5285  -  VEDANT B.C.A. AND B.COM. COLLEGE  VIJAYAPURA,1ST C,67.43,SOFTWARE PRACTICES AND TESTING ,Pass,42,8,50,BUSINESS INTELLIGENCE ,Pass,66,19,85,J2EE ,Pass,48,15,63,J2EE AND SOFTWARE TESTING LABORATORY,Pass,60,17,77,PROJECT AND VIVA VOCE ,Pass,220,57,277
M1615028, College : 5285  -  VEDANT B.C.A. AND B.COM. COLLEGE  VIJAYAPURA,DISTI,78.54,SOFTWARE PRACTICES AND TESTING ,Pass,51,18,69,BUSINESS INTELLIGENCE ,Pass,66,19,85,J2EE ,Pass,55,18,73,J2EE AND SOFTWARE TESTING LABORATORY,Pass,68,17,85,PROJECT AND VIVA VOCE ,Pass,231,55,286
M1615029, College : 5285  -  VEDANT B.C.A. AND B.COM. COLLEGE  VIJAYAPURA,DISTI,82.89,SOFTWARE PRACTICES AND TESTING ,Pass,52,19,71,BUSINESS INTELLIGENCE ,Pass,71,20,91,J2EE ,Pass,55,20,75,J2EE AND SOFTWARE TESTING LABORATORY,Pass,80,20,100,PROJECT AND VIVA VOCE ,Pass,239,60,299
M1615031, College : 5285  -  VEDANT B.C.A. AND B.COM. COLLEGE  VIJAYAPURA,DISTI,87.73,SOFTWARE PRACTICES AND TESTING ,Pass,66,20,86,BUSINESS INTELLIGENCE ,Pass,76,20,96,J2EE ,Pass,49,20,69,J2EE AND SOFTWARE TESTING LABORATORY,Pass,80,20,100,PROJECT AND VIVA VOCE ,Pass,239,60,299
M1615032, College : 5285  -  VEDANT B.C.A. AND B.COM. COLLEGE  VIJAYAPURA,DISTI,77.32,SOFTWARE PRACTICES AND TESTING ,Pass,60,17,77,BUSINESS INTELLIGENCE ,Pass,67,20,87,J2EE ,Pass,54,18,72,J2EE AND SOFTWARE TESTING LABORATORY,Pass,75,19,94,PROJECT AND VIVA VOCE ,Pass,238,59,297
M1615033, College : 5285  -  VEDANT B.C.A. AND B.COM. COLLEGE  VIJAYAPURA,DISTI,82.22,SOFTWARE PRACTICES AND TESTING ,Pass,57,19,76,BUSINESS INTELLIGENCE ,Pass,72,20,92,J2EE ,Pass,52,20,72,J2EE AND SOFTWARE TESTING LABORATORY,Pass,80,20,100,PROJECT AND VIVA VOCE ,Pass,239,59,298
M1615034, College : 5285  -  VEDANT B.C.A. AND B.COM. COLLEGE  VIJAYAPURA,N.C.L,--   ,SOFTWARE PRACTICES AND TESTING ,Pass,37,8,45,BUSINESS INTELLIGENCE ,Pass,33,15,48,J2EE ,Pass,32,10,42,J2EE AND SOFTWARE TESTING LABORATORY,Pass,55,10,65,PROJECT AND VIVA VOCE ,Pass,221,43,264
M1615035, College : 5285  -  VEDANT B.C.A. AND B.COM. COLLEGE  VIJAYAPURA,N.C.L,--   ,SOFTWARE PRACTICES AND TESTING ,Pass,47,8,55,BUSINESS INTELLIGENCE ,Pass,45,9,54,J2EE ,Pass,42,8,50,J2EE AND SOFTWARE TESTING LABORATORY,Pass,40,10,50,PROJECT AND VIVA VOCE ,Pass,190,40,230
M1615036, College : 5285  -  VEDANT B.C.A. AND B.COM. COLLEGE  VIJAYAPURA,N.C.L,--   ,SOFTWARE PRACTICES AND TESTING ,Pass,38,8,46,BUSINESS INTELLIGENCE ,Pass,40,19,59,J2EE ,Pass,32,15,47,J2EE AND SOFTWARE TESTING LABORATORY,Pass,60,16,76,PROJECT AND VIVA VOCE ,Pass,210,53,263
M1615037, College : 5285  -  VEDANT B.C.A. AND B.COM. COLLEGE  VIJAYAPURA,DISTI,74.7,SOFTWARE PRACTICES AND TESTING ,Pass,62,14,76,BUSINESS INTELLIGENCE ,Pass,60,20,80,J2EE ,Pass,45,16,61,J2EE AND SOFTWARE TESTING LABORATORY,Pass,65,18,83,PROJECT AND VIVA VOCE ,Pass,230,58,288
M1615038, College : 5285  -  VEDANT B.C.A. AND B.COM. COLLEGE  VIJAYAPURA,N.C.L,--   ,SOFTWARE PRACTICES AND TESTING ,Pass,52,17,69,BUSINESS INTELLIGENCE ,Pass,54,20,74,J2EE ,Pass,38,20,58,J2EE AND SOFTWARE TESTING LABORATORY,Pass,79,19,98,PROJECT AND VIVA VOCE ,Pass,235,60,295
M1615039, College : 5285  -  VEDANT B.C.A. AND B.COM. COLLEGE  VIJAYAPURA,N.C.L,--   ,SOFTWARE PRACTICES AND TESTING ,Pass,35,8,43,BUSINESS INTELLIGENCE ,Pass,44,16,60,J2EE ,Pass,34,13,47,J2EE AND SOFTWARE TESTING LABORATORY,Pass,60,13,73,PROJECT AND VIVA VOCE ,Pass,210,43,253
M1615040, College : 5285  -  VEDANT B.C.A. AND B.COM. COLLEGE  VIJAYAPURA,DISTI,80.14,SOFTWARE PRACTICES AND TESTING ,Pass,60,18,78,BUSINESS INTELLIGENCE ,Pass,67,20,87,J2EE ,Pass,50,20,70,J2EE AND SOFTWARE TESTING LABORATORY,Pass,80,19,99,PROJECT AND VIVA VOCE ,Pass,237,59,296
M1615041, College : 5285  -  VEDANT B.C.A. AND B.COM. COLLEGE  VIJAYAPURA,N.C.L,--   ,SOFTWARE PRACTICES AND TESTING ,Pass,33,8,41,BUSINESS INTELLIGENCE ,Pass,32,9,41,J2EE ,Pass,39,8,47,J2EE AND SOFTWARE TESTING LABORATORY,Pass,40,8,48,PROJECT AND VIVA VOCE ,Pass,180,35,215
M1615042, College : 5285  -  VEDANT B.C.A. AND B.COM. COLLEGE  VIJAYAPURA,N.C.L,--   ,SOFTWARE PRACTICES AND TESTING ,Pass,38,8,46,BUSINESS INTELLIGENCE ,Pass,32,18,50,J2EE ,Pass,46,13,59,J2EE AND SOFTWARE TESTING LABORATORY,Pass,72,15,87,PROJECT AND VIVA VOCE ,Pass,207,43,250
M1615043, College : 5285  -  VEDANT B.C.A. AND B.COM. COLLEGE  VIJAYAPURA,DISTI,79.03,SOFTWARE PRACTICES AND TESTING ,Pass,41,10,51,BUSINESS INTELLIGENCE ,Pass,47,20,67,J2EE ,Pass,44,20,64,J2EE AND SOFTWARE TESTING LABORATORY,Pass,80,20,100,PROJECT AND VIVA VOCE ,Pass,220,60,280
M1615044, College : 5285  -  VEDANT B.C.A. AND B.COM. COLLEGE  VIJAYAPURA,1ST C,68.41,SOFTWARE PRACTICES AND TESTING ,Pass,37,12,49,BUSINESS INTELLIGENCE ,Pass,42,20,62,J2EE ,Pass,36,18,54,J2EE AND SOFTWARE TESTING LABORATORY,Pass,80,19,99,PROJECT AND VIVA VOCE ,Pass,221,59,280
M1615045, College : 5285  -  VEDANT B.C.A. AND B.COM. COLLEGE  VIJAYAPURA,N.C.L,--   ,SOFTWARE PRACTICES AND TESTING ,Pass,45,17,62,BUSINESS INTELLIGENCE ,Pass,37,19,56,J2EE ,Pass,35,17,52,J2EE AND SOFTWARE TESTING LABORATORY,Pass,70,18,88,PROJECT AND VIVA VOCE ,Pass,225,53,278
M1615048, College : 5285  -  VEDANT B.C.A. AND B.COM. COLLEGE  VIJAYAPURA,N.C.L,--   ,SOFTWARE PRACTICES AND TESTING ,Pass,35,8,43,BUSINESS INTELLIGENCE ,Pass,41,18,59,J2EE ,Pass,34,14,48,J2EE AND SOFTWARE TESTING LABORATORY,Pass,70,15,85,PROJECT AND VIVA VOCE ,Pass,217,43,260
M1615049, College : 5285  -  VEDANT B.C.A. AND B.COM. COLLEGE  VIJAYAPURA,1ST C,64.08,SOFTWARE PRACTICES AND TESTING ,Pass,40,8,48,BUSINESS INTELLIGENCE ,Pass,41,19,60,J2EE ,Pass,45,15,60,J2EE AND SOFTWARE TESTING LABORATORY,Pass,78,16,94,PROJECT AND VIVA VOCE ,Pass,232,53,285
M1615050, College : 5285  -  VEDANT B.C.A. AND B.COM. COLLEGE  VIJAYAPURA,N.C.L,--   ,SOFTWARE PRACTICES AND TESTING ,Pass,34,8,42,BUSINESS INTELLIGENCE ,Pass,34,19,53,J2EE ,Pass,38,15,53,J2EE AND SOFTWARE TESTING LABORATORY,Pass,76,13,89,PROJECT AND VIVA VOCE ,Pass,230,53,283
M1615052, College : 5285  -  VEDANT B.C.A. AND B.COM. COLLEGE  VIJAYAPURA,DISTI,75.81,SOFTWARE PRACTICES AND TESTING ,Pass,48,16,64,BUSINESS INTELLIGENCE ,Pass,53,20,73,J2EE ,Pass,48,16,64,J2EE AND SOFTWARE TESTING LABORATORY,Pass,80,19,99,PROJECT AND VIVA VOCE ,Pass,237,56,293
M1615054, College : 5285  -  VEDANT B.C.A. AND B.COM. COLLEGE  VIJAYAPURA,N.C.L,--   ,SOFTWARE PRACTICES AND TESTING ,Pass,38,8,46,BUSINESS INTELLIGENCE ,Pass,36,18,54,J2EE ,Pass,42,15,57,J2EE AND SOFTWARE TESTING LABORATORY,Pass,76,17,93,PROJECT AND VIVA VOCE ,Pass,232,53,285
M1615055, College : 5285  -  VEDANT B.C.A. AND B.COM. COLLEGE  VIJAYAPURA,DISTI,72.89,SOFTWARE PRACTICES AND TESTING ,Pass,47,18,65,BUSINESS INTELLIGENCE ,Pass,56,19,75,J2EE ,Pass,41,18,59,J2EE AND SOFTWARE TESTING LABORATORY,Pass,79,19,98,PROJECT AND VIVA VOCE ,Pass,235,59,294
M1615057, College : 5285  -  VEDANT B.C.A. AND B.COM. COLLEGE  VIJAYAPURA,DISTI,85.38,SOFTWARE PRACTICES AND TESTING ,Pass,60,17,77,BUSINESS INTELLIGENCE ,Pass,70,20,90,J2EE ,Pass,52,20,72,J2EE AND SOFTWARE TESTING LABORATORY,Pass,80,20,100,PROJECT AND VIVA VOCE ,Pass,239,60,299
M1615060, College : 5285  -  VEDANT B.C.A. AND B.COM. COLLEGE  VIJAYAPURA,DISTI,84.19,SOFTWARE PRACTICES AND TESTING ,Pass,53,15,68,BUSINESS INTELLIGENCE ,Pass,63,20,83,J2EE ,Pass,52,20,72,J2EE AND SOFTWARE TESTING LABORATORY,Pass,80,20,100,PROJECT AND VIVA VOCE ,Pass,237,60,297
M1615201, College : 5287  -  KONIKA B.B.A. AND B.C.A. COLLEGE  VIJAYAPURA,N.C.L,--   ,SOFTWARE PRACTICES AND TESTING ,Pass,58,19,77,BUSINESS INTELLIGENCE ,Pass,66,19,85,J2EE ,Pass,61,19,80,J2EE AND SOFTWARE TESTING LABORATORY,Pass,69,19,88,PROJECT AND VIVA VOCE ,Pass,226,58,284
M1615202, College : 5287  -  KONIKA B.B.A. AND B.C.A. COLLEGE  VIJAYAPURA,N.C.L,--   ,SOFTWARE PRACTICES AND TESTING ,Pass,55,19,74,BUSINESS INTELLIGENCE ,Pass,53,19,72,J2EE ,Pass,59,19,78,J2EE AND SOFTWARE TESTING LABORATORY,Pass,69,19,88,PROJECT AND VIVA VOCE ,Pass,225,58,283
M1615203, College : 5287  -  KONIKA B.B.A. AND B.C.A. COLLEGE  VIJAYAPURA,DISTI,89.92,SOFTWARE PRACTICES AND TESTING ,Pass,54,20,74,BUSINESS INTELLIGENCE ,Pass,67,20,87,J2EE ,Pass,52,20,72,J2EE AND SOFTWARE TESTING LABORATORY,Pass,80,20,100,PROJECT AND VIVA VOCE ,Pass,240,60,300
M1615204, College : 5287  -  KONIKA B.B.A. AND B.C.A. COLLEGE  VIJAYAPURA,DISTI,75.41,SOFTWARE PRACTICES AND TESTING ,Pass,35,19,54,BUSINESS INTELLIGENCE ,Pass,60,18,78,J2EE ,Pass,36,19,55,J2EE AND SOFTWARE TESTING LABORATORY,Pass,75,19,94,PROJECT AND VIVA VOCE ,Pass,235,59,294
M1615206, College : 5287  -  KONIKA B.B.A. AND B.C.A. COLLEGE  VIJAYAPURA,N.C.L,--   ,SOFTWARE PRACTICES AND TESTING ,Pass,49,18,67,BUSINESS INTELLIGENCE ,Pass,49,17,66,J2EE ,Pass,43,17,60,J2EE AND SOFTWARE TESTING LABORATORY,Pass,63,17,80,PROJECT AND VIVA VOCE ,Pass,215,54,269
M1615207, College : 5287  -  KONIKA B.B.A. AND B.C.A. COLLEGE  VIJAYAPURA,DISTI,80.65,SOFTWARE PRACTICES AND TESTING ,Pass,40,19,59,BUSINESS INTELLIGENCE ,Pass,73,19,92,J2EE ,Pass,35,20,55,J2EE AND SOFTWARE TESTING LABORATORY,Pass,77,20,97,PROJECT AND VIVA VOCE ,Pass,240,60,300
M1615208, College : 5287  -  KONIKA B.B.A. AND B.C.A. COLLEGE  VIJAYAPURA,DISTI,78.22,SOFTWARE PRACTICES AND TESTING ,Pass,45,19,64,BUSINESS INTELLIGENCE ,Pass,62,19,81,J2EE ,Pass,33,19,52,J2EE AND SOFTWARE TESTING LABORATORY,Pass,75,18,93,PROJECT AND VIVA VOCE ,Pass,238,60,298
M1615209, College : 5287  -  KONIKA B.B.A. AND B.C.A. COLLEGE  VIJAYAPURA,DISTI,77.89,SOFTWARE PRACTICES AND TESTING ,Pass,40,19,59,BUSINESS INTELLIGENCE ,Pass,58,19,77,J2EE ,Pass,35,19,54,J2EE AND SOFTWARE TESTING LABORATORY,Pass,76,19,95,PROJECT AND VIVA VOCE ,Pass,240,60,300
M1615212, College : 5287  -  KONIKA B.B.A. AND B.C.A. COLLEGE  VIJAYAPURA,DISTI,84.97,SOFTWARE PRACTICES AND TESTING ,Pass,60,19,79,BUSINESS INTELLIGENCE ,Pass,70,19,89,J2EE ,Pass,46,19,65,J2EE AND SOFTWARE TESTING LABORATORY,Pass,76,20,96,PROJECT AND VIVA VOCE ,Pass,238,60,298
M1615214, College : 5287  -  KONIKA B.B.A. AND B.C.A. COLLEGE  VIJAYAPURA,DISTI,74.24,SOFTWARE PRACTICES AND TESTING ,Pass,32,19,51,BUSINESS INTELLIGENCE ,Pass,68,19,87,J2EE ,Pass,34,19,53,J2EE AND SOFTWARE TESTING LABORATORY,Pass,75,19,94,PROJECT AND VIVA VOCE ,Pass,230,60,290
M1615215, College : 5287  -  KONIKA B.B.A. AND B.C.A. COLLEGE  VIJAYAPURA,DISTI,79.57,SOFTWARE PRACTICES AND TESTING ,Pass,43,19,62,BUSINESS INTELLIGENCE ,Pass,72,19,91,J2EE ,Pass,42,19,61,J2EE AND SOFTWARE TESTING LABORATORY,Pass,76,19,95,PROJECT AND VIVA VOCE ,Pass,230,60,290
M1615216, College : 5287  -  KONIKA B.B.A. AND B.C.A. COLLEGE  VIJAYAPURA,FAIL,67.86,SOFTWARE PRACTICES AND TESTING ,Fail,20,16,36,BUSINESS INTELLIGENCE ,Pass,58,17,75,J2EE ,Pass,32,17,49,J2EE AND SOFTWARE TESTING LABORATORY,Pass,50,15,65,PROJECT AND VIVA VOCE ,Pass,200,50,250
M1615217, College : 5287  -  KONIKA B.B.A. AND B.C.A. COLLEGE  VIJAYAPURA,DISTI,81.76,SOFTWARE PRACTICES AND TESTING ,Pass,37,19,56,BUSINESS INTELLIGENCE ,Pass,71,19,90,J2EE ,Pass,35,19,54,J2EE AND SOFTWARE TESTING LABORATORY,Pass,76,20,96,PROJECT AND VIVA VOCE ,Pass,230,60,290
M1615218, College : 5287  -  KONIKA B.B.A. AND B.C.A. COLLEGE  VIJAYAPURA,DISTI,78.38,SOFTWARE PRACTICES AND TESTING ,Pass,44,19,63,BUSINESS INTELLIGENCE ,Pass,59,19,78,J2EE ,Pass,34,19,53,J2EE AND SOFTWARE TESTING LABORATORY,Pass,78,20,98,PROJECT AND VIVA VOCE ,Pass,240,60,300
M1615219, College : 5287  -  KONIKA B.B.A. AND B.C.A. COLLEGE  VIJAYAPURA,N.C.L,--   ,SOFTWARE PRACTICES AND TESTING ,Pass,37,18,55,BUSINESS INTELLIGENCE ,Pass,53,18,71,J2EE ,Pass,35,18,53,J2EE AND SOFTWARE TESTING LABORATORY,Pass,55,19,74,PROJECT AND VIVA VOCE ,Pass,230,60,290
M1615220, College : 5287  -  KONIKA B.B.A. AND B.C.A. COLLEGE  VIJAYAPURA,DISTI,77.59,SOFTWARE PRACTICES AND TESTING ,Pass,48,19,67,BUSINESS INTELLIGENCE ,Pass,70,19,89,J2EE ,Pass,39,19,58,J2EE AND SOFTWARE TESTING LABORATORY,Pass,68,20,88,PROJECT AND VIVA VOCE ,Pass,230,60,290
M1615221, College : 5287  -  KONIKA B.B.A. AND B.C.A. COLLEGE  VIJAYAPURA,DISTI,79.86,SOFTWARE PRACTICES AND TESTING ,Pass,48,18,66,BUSINESS INTELLIGENCE ,Pass,61,19,80,J2EE ,Pass,41,19,60,J2EE AND SOFTWARE TESTING LABORATORY,Pass,76,19,95,PROJECT AND VIVA VOCE ,Pass,237,60,297
M1615222, College : 5287  -  KONIKA B.B.A. AND B.C.A. COLLEGE  VIJAYAPURA,N.C.L,--   ,SOFTWARE PRACTICES AND TESTING ,Pass,32,18,50,BUSINESS INTELLIGENCE ,Pass,53,18,71,J2EE ,Pass,32,18,50,J2EE AND SOFTWARE TESTING LABORATORY,Pass,62,18,80,PROJECT AND VIVA VOCE ,Pass,230,58,288
M1615223, College : 5287  -  KONIKA B.B.A. AND B.C.A. COLLEGE  VIJAYAPURA,DISTI,82.78,SOFTWARE PRACTICES AND TESTING ,Pass,54,19,73,BUSINESS INTELLIGENCE ,Pass,69,19,88,J2EE ,Pass,49,19,68,J2EE AND SOFTWARE TESTING LABORATORY,Pass,71,19,90,PROJECT AND VIVA VOCE ,Pass,239,60,299
M1615225, College : 5287  -  KONIKA B.B.A. AND B.C.A. COLLEGE  VIJAYAPURA,DISTI,86.76,SOFTWARE PRACTICES AND TESTING ,Pass,54,19,73,BUSINESS INTELLIGENCE ,Pass,72,19,91,J2EE ,Pass,59,19,78,J2EE AND SOFTWARE TESTING LABORATORY,Pass,80,20,100,PROJECT AND VIVA VOCE ,Pass,240,60,300
M1615226, College : 5287  -  KONIKA B.B.A. AND B.C.A. COLLEGE  VIJAYAPURA,DISTI,76.84,SOFTWARE PRACTICES AND TESTING ,Pass,53,19,72,BUSINESS INTELLIGENCE ,Pass,76,19,95,J2EE ,Pass,48,19,67,J2EE AND SOFTWARE TESTING LABORATORY,Pass,74,20,94,PROJECT AND VIVA VOCE ,Pass,230,60,290
M1615227, College : 5287  -  KONIKA B.B.A. AND B.C.A. COLLEGE  VIJAYAPURA,FAIL,73.43,SOFTWARE PRACTICES AND TESTING ,Pass,32,18,50,BUSINESS INTELLIGENCE ,Pass,35,19,54,J2EE ,Fail,18,18,36,J2EE AND SOFTWARE TESTING LABORATORY,Pass,65,19,84,PROJECT AND VIVA VOCE ,Pass,230,60,290
M1615228, College : 5287  -  KONIKA B.B.A. AND B.C.A. COLLEGE  VIJAYAPURA,N.C.L,--   ,SOFTWARE PRACTICES AND TESTING ,Pass,40,16,56,BUSINESS INTELLIGENCE ,Pass,61,17,78,J2EE ,Pass,34,17,51,J2EE AND SOFTWARE TESTING LABORATORY,Pass,50,16,66,PROJECT AND VIVA VOCE ,Pass,200,50,250
M1615229, College : 5287  -  KONIKA B.B.A. AND B.C.A. COLLEGE  VIJAYAPURA,N.C.L,--   ,SOFTWARE PRACTICES AND TESTING ,Pass,53,18,71,BUSINESS INTELLIGENCE ,Pass,71,19,90,J2EE ,Pass,40,19,59,J2EE AND SOFTWARE TESTING LABORATORY,Pass,70,19,89,PROJECT AND VIVA VOCE ,Pass,235,60,295
M1615230, College : 5287  -  KONIKA B.B.A. AND B.C.A. COLLEGE  VIJAYAPURA,N.C.L,--   ,SOFTWARE PRACTICES AND TESTING ,Pass,52,18,70,BUSINESS INTELLIGENCE ,Pass,53,18,71,J2EE ,Pass,33,18,51,J2EE AND SOFTWARE TESTING LABORATORY,Pass,68,19,87,PROJECT AND VIVA VOCE ,Pass,230,60,290
M1615233, College : 5287  -  KONIKA B.B.A. AND B.C.A. COLLEGE  VIJAYAPURA,DISTI,75.81,SOFTWARE PRACTICES AND TESTING ,Pass,59,19,78,BUSINESS INTELLIGENCE ,Pass,70,18,88,J2EE ,Pass,48,18,66,J2EE AND SOFTWARE TESTING LABORATORY,Pass,68,19,87,PROJECT AND VIVA VOCE ,Pass,230,60,290
M1615234, College : 5287  -  KONIKA B.B.A. AND B.C.A. COLLEGE  VIJAYAPURA,DISTI,77.81,SOFTWARE PRACTICES AND TESTING ,Pass,59,19,78,BUSINESS INTELLIGENCE ,Pass,60,19,79,J2EE ,Pass,49,19,68,J2EE AND SOFTWARE TESTING LABORATORY,Pass,77,19,96,PROJECT AND VIVA VOCE ,Pass,239,60,299
M1615235, College : 5287  -  KONIKA B.B.A. AND B.C.A. COLLEGE  VIJAYAPURA,DISTI,78.16,SOFTWARE PRACTICES AND TESTING ,Pass,57,19,76,BUSINESS INTELLIGENCE ,Pass,68,19,87,J2EE ,Pass,48,19,67,J2EE AND SOFTWARE TESTING LABORATORY,Pass,70,20,90,PROJECT AND VIVA VOCE ,Pass,230,60,290
M1615237, College : 5287  -  KONIKA B.B.A. AND B.C.A. COLLEGE  VIJAYAPURA,DISTI,80,SOFTWARE PRACTICES AND TESTING ,Pass,54,20,74,BUSINESS INTELLIGENCE ,Pass,64,19,83,J2EE ,Pass,41,19,60,J2EE AND SOFTWARE TESTING LABORATORY,Pass,64,18,82,PROJECT AND VIVA VOCE ,Pass,235,60,295
M1615240, College : 5287  -  KONIKA B.B.A. AND B.C.A. COLLEGE  VIJAYAPURA,N.C.L,--   ,SOFTWARE PRACTICES AND TESTING ,Pass,52,18,70,BUSINESS INTELLIGENCE ,Pass,58,18,76,J2EE ,Pass,49,18,67,J2EE AND SOFTWARE TESTING LABORATORY,Pass,68,17,85,PROJECT AND VIVA VOCE ,Pass,230,50,280
M1615241, College : 5287  -  KONIKA B.B.A. AND B.C.A. COLLEGE  VIJAYAPURA,DISTI,84,SOFTWARE PRACTICES AND TESTING ,Pass,56,19,75,BUSINESS INTELLIGENCE ,Pass,69,19,88,J2EE ,Pass,55,19,74,J2EE AND SOFTWARE TESTING LABORATORY,Pass,72,20,92,PROJECT AND VIVA VOCE ,Pass,238,60,298
M1615243, College : 5287  -  KONIKA B.B.A. AND B.C.A. COLLEGE  VIJAYAPURA,N.C.L,--   ,SOFTWARE PRACTICES AND TESTING ,Pass,32,18,50,BUSINESS INTELLIGENCE ,Pass,47,18,65,J2EE ,Pass,39,18,57,J2EE AND SOFTWARE TESTING LABORATORY,Pass,62,19,81,PROJECT AND VIVA VOCE ,Pass,230,60,290
M1615244, College : 5287  -  KONIKA B.B.A. AND B.C.A. COLLEGE  VIJAYAPURA,DISTI,88.11,SOFTWARE PRACTICES AND TESTING ,Pass,64,20,84,BUSINESS INTELLIGENCE ,Pass,75,20,95,J2EE ,Pass,51,20,71,J2EE AND SOFTWARE TESTING LABORATORY,Pass,80,20,100,PROJECT AND VIVA VOCE ,Pass,240,60,300
M1615245, College : 5287  -  KONIKA B.B.A. AND B.C.A. COLLEGE  VIJAYAPURA,DISTI,89.27,SOFTWARE PRACTICES AND TESTING ,Pass,63,20,83,BUSINESS INTELLIGENCE ,Pass,72,20,92,J2EE ,Pass,51,20,71,J2EE AND SOFTWARE TESTING LABORATORY,Pass,80,20,100,PROJECT AND VIVA VOCE ,Pass,240,60,300
M1615246, College : 5287  -  KONIKA B.B.A. AND B.C.A. COLLEGE  VIJAYAPURA,DISTI,80.81,SOFTWARE PRACTICES AND TESTING ,Pass,59,18,77,BUSINESS INTELLIGENCE ,Pass,69,19,88,J2EE ,Pass,59,19,78,J2EE AND SOFTWARE TESTING LABORATORY,Pass,78,19,97,PROJECT AND VIVA VOCE ,Pass,236,60,296
M1615247, College : 5287  -  KONIKA B.B.A. AND B.C.A. COLLEGE  VIJAYAPURA,DISTI,81.59,SOFTWARE PRACTICES AND TESTING ,Pass,61,19,80,BUSINESS INTELLIGENCE ,Pass,68,19,87,J2EE ,Pass,64,19,83,J2EE AND SOFTWARE TESTING LABORATORY,Pass,70,19,89,PROJECT AND VIVA VOCE ,Pass,235,60,295
M1615248, College : 5287  -  KONIKA B.B.A. AND B.C.A. COLLEGE  VIJAYAPURA,DISTI,82.41,SOFTWARE PRACTICES AND TESTING ,Pass,52,19,71,BUSINESS INTELLIGENCE ,Pass,54,19,73,J2EE ,Pass,48,19,67,J2EE AND SOFTWARE TESTING LABORATORY,Pass,75,18,93,PROJECT AND VIVA VOCE ,Pass,239,60,299
M1615249, College : 5287  -  KONIKA B.B.A. AND B.C.A. COLLEGE  VIJAYAPURA,DISTI,81.22,SOFTWARE PRACTICES AND TESTING ,Pass,51,19,70,BUSINESS INTELLIGENCE ,Pass,58,19,77,J2EE ,Pass,47,18,65,J2EE AND SOFTWARE TESTING LABORATORY,Pass,75,19,94,PROJECT AND VIVA VOCE ,Pass,239,60,299
M1615250, College : 5287  -  KONIKA B.B.A. AND B.C.A. COLLEGE  VIJAYAPURA,DISTI,71.89,SOFTWARE PRACTICES AND TESTING ,Pass,55,19,74,BUSINESS INTELLIGENCE ,Pass,42,19,61,J2EE ,Pass,55,18,73,J2EE AND SOFTWARE TESTING LABORATORY,Pass,74,18,92,PROJECT AND VIVA VOCE ,Pass,236,60,296
M1615251, College : 5287  -  KONIKA B.B.A. AND B.C.A. COLLEGE  VIJAYAPURA,1ST C,69.65,SOFTWARE PRACTICES AND TESTING ,Pass,49,19,68,BUSINESS INTELLIGENCE ,Pass,46,19,65,J2EE ,Pass,41,19,60,J2EE AND SOFTWARE TESTING LABORATORY,Pass,68,19,87,PROJECT AND VIVA VOCE ,Pass,230,60,290
M1615252, College : 5287  -  KONIKA B.B.A. AND B.C.A. COLLEGE  VIJAYAPURA,DISTI,89.32,SOFTWARE PRACTICES AND TESTING ,Pass,66,20,86,BUSINESS INTELLIGENCE ,Pass,60,20,80,J2EE ,Pass,66,20,86,J2EE AND SOFTWARE TESTING LABORATORY,Pass,80,20,100,PROJECT AND VIVA VOCE ,Pass,240,60,300
M1615253, College : 5287  -  KONIKA B.B.A. AND B.C.A. COLLEGE  VIJAYAPURA,N.C.L,--   ,SOFTWARE PRACTICES AND TESTING ,Pass,50,18,68,BUSINESS INTELLIGENCE ,Pass,50,18,68,J2EE ,Pass,60,17,77,J2EE AND SOFTWARE TESTING LABORATORY,Pass,76,18,94,PROJECT AND VIVA VOCE ,Pass,236,55,291
M1615401, College : 6204  -  BASAVESHWAR SCIENCE COLLEGE  BAGALKOT,N.C.L,--   ,SOFTWARE PRACTICES AND TESTING ,Pass,48,17,65,BUSINESS INTELLIGENCE ,Pass,53,16,69,J2EE ,Pass,47,16,63,J2EE AND SOFTWARE TESTING LABORATORY,Pass,60,18,78,PROJECT AND VIVA VOCE ,Pass,210,51,261
M1615402, College : 6204  -  BASAVESHWAR SCIENCE COLLEGE  BAGALKOT,N.C.L,--   ,SOFTWARE PRACTICES AND TESTING ,Pass,62,20,82,BUSINESS INTELLIGENCE ,Pass,56,19,75,J2EE ,Pass,53,19,72,J2EE AND SOFTWARE TESTING LABORATORY,Pass,75,20,95,PROJECT AND VIVA VOCE ,Pass,236,58,294
M1615403, College : 6204  -  BASAVESHWAR SCIENCE COLLEGE  BAGALKOT,N.C.L,--   ,SOFTWARE PRACTICES AND TESTING ,Pass,32,10,42,BUSINESS INTELLIGENCE ,Pass,32,10,42,J2EE ,Pass,34,12,46,J2EE AND SOFTWARE TESTING LABORATORY,Pass,65,15,80,PROJECT AND VIVA VOCE ,Pass,220,55,275
M1615404, College : 6204  -  BASAVESHWAR SCIENCE COLLEGE  BAGALKOT,N.C.L,--   ,SOFTWARE PRACTICES AND TESTING ,Pass,32,16,48,BUSINESS INTELLIGENCE ,Pass,32,18,50,J2EE ,Pass,33,18,51,J2EE AND SOFTWARE TESTING LABORATORY,Pass,70,18,88,PROJECT AND VIVA VOCE ,Pass,230,58,288
M1615405, College : 6204  -  BASAVESHWAR SCIENCE COLLEGE  BAGALKOT,FAIL,70.57,SOFTWARE PRACTICES AND TESTING ,Fail,Ab.,20,20,BUSINESS INTELLIGENCE ,Pass,41,17,58,J2EE ,Fail,19,18,37,J2EE AND SOFTWARE TESTING LABORATORY,Pass,70,19,89,PROJECT AND VIVA VOCE ,Pass,232,58,290
M1615406, College : 6204  -  BASAVESHWAR SCIENCE COLLEGE  BAGALKOT,DISTI,71.81,SOFTWARE PRACTICES AND TESTING ,Pass,41,20,61,BUSINESS INTELLIGENCE ,Pass,52,20,72,J2EE ,Pass,36,19,55,J2EE AND SOFTWARE TESTING LABORATORY,Pass,75,20,95,PROJECT AND VIVA VOCE ,Pass,236,59,295
M1615407, College : 6204  -  BASAVESHWAR SCIENCE COLLEGE  BAGALKOT,N.C.L,--   ,SOFTWARE PRACTICES AND TESTING ,Pass,37,18,55,BUSINESS INTELLIGENCE ,Pass,43,18,61,J2EE ,Pass,32,18,50,J2EE AND SOFTWARE TESTING LABORATORY,Pass,70,18,88,PROJECT AND VIVA VOCE ,Pass,228,55,283
M1615409, College : 6204  -  BASAVESHWAR SCIENCE COLLEGE  BAGALKOT,N.C.L,--   ,SOFTWARE PRACTICES AND TESTING ,Pass,46,17,63,BUSINESS INTELLIGENCE ,Pass,54,17,71,J2EE ,Pass,36,18,54,J2EE AND SOFTWARE TESTING LABORATORY,Pass,74,18,92,PROJECT AND VIVA VOCE ,Pass,235,56,291
M1615410, College : 6204  -  BASAVESHWAR SCIENCE COLLEGE  BAGALKOT,N.C.L,--   ,SOFTWARE PRACTICES AND TESTING ,Pass,42,12,54,BUSINESS INTELLIGENCE ,Pass,52,12,64,J2EE ,Pass,32,16,48,J2EE AND SOFTWARE TESTING LABORATORY,Pass,70,16,86,PROJECT AND VIVA VOCE ,Pass,229,55,284
M1615413, College : 6204  -  BASAVESHWAR SCIENCE COLLEGE  BAGALKOT,N.C.L,--   ,SOFTWARE PRACTICES AND TESTING ,Pass,41,14,55,BUSINESS INTELLIGENCE ,Pass,49,15,64,J2EE ,Pass,32,16,48,J2EE AND SOFTWARE TESTING LABORATORY,Pass,75,17,92,PROJECT AND VIVA VOCE ,Pass,235,57,292
M1615601, College : 6210  -  VIDHYAPRASARAK SOCIETY S COLLEGE OF B.C.A.  BAGALKOT,DISTI,81.03,SOFTWARE PRACTICES AND TESTING ,Pass,56,19,75,BUSINESS INTELLIGENCE ,Pass,68,19,87,J2EE ,Pass,49,20,69,J2EE AND SOFTWARE TESTING LABORATORY,Pass,77,18,95,PROJECT AND VIVA VOCE ,Pass,210,60,270
M1615602, College : 6210  -  VIDHYAPRASARAK SOCIETY S COLLEGE OF B.C.A.  BAGALKOT,DISTI,74.57,SOFTWARE PRACTICES AND TESTING ,Pass,49,16,65,BUSINESS INTELLIGENCE ,Pass,68,17,85,J2EE ,Pass,59,18,77,J2EE AND SOFTWARE TESTING LABORATORY,Pass,59,18,77,PROJECT AND VIVA VOCE ,Pass,215,60,275
M1615603, College : 6210  -  VIDHYAPRASARAK SOCIETY S COLLEGE OF B.C.A.  BAGALKOT,FAIL,27.29,SOFTWARE PRACTICES AND TESTING ,Pass,32,10,42,BUSINESS INTELLIGENCE ,Pass,32,10,42,J2EE ,Pass,35,10,45,J2EE AND SOFTWARE TESTING LABORATORY,Fail,Ab.,14,14,PROJECT AND VIVA VOCE ,Fail,Ab.,48,48
M1615605, College : 6210  -  VIDHYAPRASARAK SOCIETY S COLLEGE OF B.C.A.  BAGALKOT,N.C.L,--   ,SOFTWARE PRACTICES AND TESTING ,Pass,34,10,44,BUSINESS INTELLIGENCE ,Pass,35,10,45,J2EE ,Pass,35,10,45,J2EE AND SOFTWARE TESTING LABORATORY,Pass,52,10,62,PROJECT AND VIVA VOCE ,Pass,208,50,258
M1615606, College : 6210  -  VIDHYAPRASARAK SOCIETY S COLLEGE OF B.C.A.  BAGALKOT,DISTI,71.19,SOFTWARE PRACTICES AND TESTING ,Pass,56,18,74,BUSINESS INTELLIGENCE ,Pass,49,16,65,J2EE ,Pass,39,17,56,J2EE AND SOFTWARE TESTING LABORATORY,Pass,61,18,79,PROJECT AND VIVA VOCE ,Pass,222,58,280
M1615607, College : 6210  -  VIDHYAPRASARAK SOCIETY S COLLEGE OF B.C.A.  BAGALKOT,N.C.L,--   ,SOFTWARE PRACTICES AND TESTING ,Pass,32,14,46,BUSINESS INTELLIGENCE ,Pass,35,11,46,J2EE ,Pass,32,12,44,J2EE AND SOFTWARE TESTING LABORATORY,Pass,50,16,66,PROJECT AND VIVA VOCE ,Pass,209,58,267
M1615608, College : 6210  -  VIDHYAPRASARAK SOCIETY S COLLEGE OF B.C.A.  BAGALKOT,N.C.L,--   ,SOFTWARE PRACTICES AND TESTING ,Pass,53,17,70,BUSINESS INTELLIGENCE ,Pass,63,17,80,J2EE ,Pass,49,18,67,J2EE AND SOFTWARE TESTING LABORATORY,Pass,65,19,84,PROJECT AND VIVA VOCE ,Pass,220,52,272
M1615609, College : 6210  -  VIDHYAPRASARAK SOCIETY S COLLEGE OF B.C.A.  BAGALKOT,N.C.L,--   ,SOFTWARE PRACTICES AND TESTING ,Pass,44,17,61,BUSINESS INTELLIGENCE ,Pass,47,12,59,J2EE ,Pass,42,16,58,J2EE AND SOFTWARE TESTING LABORATORY,Pass,50,17,67,PROJECT AND VIVA VOCE ,Pass,210,58,268
M1615610, College : 6210  -  VIDHYAPRASARAK SOCIETY S COLLEGE OF B.C.A.  BAGALKOT,N.C.L,--   ,SOFTWARE PRACTICES AND TESTING ,Pass,41,18,59,BUSINESS INTELLIGENCE ,Pass,49,17,66,J2EE ,Pass,36,18,54,J2EE AND SOFTWARE TESTING LABORATORY,Pass,66,18,84,PROJECT AND VIVA VOCE ,Pass,221,52,273
M1615611, College : 6210  -  VIDHYAPRASARAK SOCIETY S COLLEGE OF B.C.A.  BAGALKOT,N.C.L,--   ,SOFTWARE PRACTICES AND TESTING ,Pass,50,20,70,BUSINESS INTELLIGENCE ,Pass,60,16,76,J2EE ,Pass,55,19,74,J2EE AND SOFTWARE TESTING LABORATORY,Pass,52,17,69,PROJECT AND VIVA VOCE ,Pass,210,58,268
M1615612, College : 6210  -  VIDHYAPRASARAK SOCIETY S COLLEGE OF B.C.A.  BAGALKOT,FAIL,59.71,SOFTWARE PRACTICES AND TESTING ,Fail,10,10,20,BUSINESS INTELLIGENCE ,Pass,45,9,54,J2EE ,Fail,9,12,21,J2EE AND SOFTWARE TESTING LABORATORY,Pass,50,17,67,PROJECT AND VIVA VOCE ,Pass,200,56,256
M1615613, College : 6210  -  VIDHYAPRASARAK SOCIETY S COLLEGE OF B.C.A.  BAGALKOT,N.C.L,--   ,SOFTWARE PRACTICES AND TESTING ,Pass,44,19,63,BUSINESS INTELLIGENCE ,Pass,56,16,72,J2EE ,Pass,50,17,67,J2EE AND SOFTWARE TESTING LABORATORY,Pass,51,17,68,PROJECT AND VIVA VOCE ,Pass,208,58,266
M1615614, College : 6210  -  VIDHYAPRASARAK SOCIETY S COLLEGE OF B.C.A.  BAGALKOT,N.C.L,--   ,SOFTWARE PRACTICES AND TESTING ,Pass,47,12,59,BUSINESS INTELLIGENCE ,Pass,36,12,48,J2EE ,Pass,41,15,56,J2EE AND SOFTWARE TESTING LABORATORY,Pass,50,17,67,PROJECT AND VIVA VOCE ,Pass,210,60,270
M1615615, College : 6210  -  VIDHYAPRASARAK SOCIETY S COLLEGE OF B.C.A.  BAGALKOT,1ST C,65.95,SOFTWARE PRACTICES AND TESTING ,Pass,56,12,68,BUSINESS INTELLIGENCE ,Pass,59,15,74,J2EE ,Pass,32,10,42,J2EE AND SOFTWARE TESTING LABORATORY,Pass,50,16,66,PROJECT AND VIVA VOCE ,Pass,200,55,255
M1615616, College : 6210  -  VIDHYAPRASARAK SOCIETY S COLLEGE OF B.C.A.  BAGALKOT,N.C.L,--   ,SOFTWARE PRACTICES AND TESTING ,Pass,52,19,71,BUSINESS INTELLIGENCE ,Pass,43,16,59,J2EE ,Pass,35,15,50,J2EE AND SOFTWARE TESTING LABORATORY,Pass,53,17,70,PROJECT AND VIVA VOCE ,Pass,210,58,268
M1615618, College : 6210  -  VIDHYAPRASARAK SOCIETY S COLLEGE OF B.C.A.  BAGALKOT,DISTI,84.92,SOFTWARE PRACTICES AND TESTING ,Pass,68,18,86,BUSINESS INTELLIGENCE ,Pass,68,18,86,J2EE ,Pass,69,19,88,J2EE AND SOFTWARE TESTING LABORATORY,Pass,80,20,100,PROJECT AND VIVA VOCE ,Pass,235,60,295
M1615619, College : 6210  -  VIDHYAPRASARAK SOCIETY S COLLEGE OF B.C.A.  BAGALKOT,1ST C,67.92,SOFTWARE PRACTICES AND TESTING ,Pass,57,14,71,BUSINESS INTELLIGENCE ,Pass,47,15,62,J2EE ,Pass,62,12,74,J2EE AND SOFTWARE TESTING LABORATORY,Pass,50,12,62,PROJECT AND VIVA VOCE ,Pass,202,53,255
M1615620, College : 6210  -  VIDHYAPRASARAK SOCIETY S COLLEGE OF B.C.A.  BAGALKOT,N.C.L,--   ,SOFTWARE PRACTICES AND TESTING ,Pass,55,14,69,BUSINESS INTELLIGENCE ,Pass,50,16,66,J2EE ,Pass,54,15,69,J2EE AND SOFTWARE TESTING LABORATORY,Pass,50,16,66,PROJECT AND VIVA VOCE ,Pass,210,55,265
M1615621, College : 6210  -  VIDHYAPRASARAK SOCIETY S COLLEGE OF B.C.A.  BAGALKOT,N.C.L,--   ,SOFTWARE PRACTICES AND TESTING ,Pass,32,15,47,BUSINESS INTELLIGENCE ,Pass,32,14,46,J2EE ,Pass,35,14,49,J2EE AND SOFTWARE TESTING LABORATORY,Pass,58,18,76,PROJECT AND VIVA VOCE ,Pass,203,52,255
M1615622, College : 6210  -  VIDHYAPRASARAK SOCIETY S COLLEGE OF B.C.A.  BAGALKOT,DISTI,78.73,SOFTWARE PRACTICES AND TESTING ,Pass,46,19,65,BUSINESS INTELLIGENCE ,Pass,61,15,76,J2EE ,Pass,50,19,69,J2EE AND SOFTWARE TESTING LABORATORY,Pass,52,18,70,PROJECT AND VIVA VOCE ,Pass,220,56,276
M1615623, College : 6210  -  VIDHYAPRASARAK SOCIETY S COLLEGE OF B.C.A.  BAGALKOT,DISTI,70.7,SOFTWARE PRACTICES AND TESTING ,Pass,44,18,62,BUSINESS INTELLIGENCE ,Pass,46,15,61,J2EE ,Pass,55,17,72,J2EE AND SOFTWARE TESTING LABORATORY,Pass,50,16,66,PROJECT AND VIVA VOCE ,Pass,220,60,280
M1615624, College : 6210  -  VIDHYAPRASARAK SOCIETY S COLLEGE OF B.C.A.  BAGALKOT,1ST C,60.73,SOFTWARE PRACTICES AND TESTING ,Pass,50,14,64,BUSINESS INTELLIGENCE ,Pass,38,11,49,J2EE ,Pass,49,15,64,J2EE AND SOFTWARE TESTING LABORATORY,Pass,50,16,66,PROJECT AND VIVA VOCE ,Pass,210,55,265
M1615625, College : 6210  -  VIDHYAPRASARAK SOCIETY S COLLEGE OF B.C.A.  BAGALKOT,N.C.L,--   ,SOFTWARE PRACTICES AND TESTING ,Pass,33,14,47,BUSINESS INTELLIGENCE ,Pass,32,10,42,J2EE ,Pass,43,15,58,J2EE AND SOFTWARE TESTING LABORATORY,Pass,50,16,66,PROJECT AND VIVA VOCE ,Pass,165,52,217
M1615626, College : 6210  -  VIDHYAPRASARAK SOCIETY S COLLEGE OF B.C.A.  BAGALKOT,N.C.L,--   ,SOFTWARE PRACTICES AND TESTING ,Pass,51,17,68,BUSINESS INTELLIGENCE ,Pass,50,17,67,J2EE ,Pass,40,17,57,J2EE AND SOFTWARE TESTING LABORATORY,Pass,61,17,78,PROJECT AND VIVA VOCE ,Pass,216,52,268
M1615628, College : 6210  -  VIDHYAPRASARAK SOCIETY S COLLEGE OF B.C.A.  BAGALKOT,DISTI,73.3,SOFTWARE PRACTICES AND TESTING ,Pass,69,18,87,BUSINESS INTELLIGENCE ,Pass,71,17,88,J2EE ,Pass,54,17,71,J2EE AND SOFTWARE TESTING LABORATORY,Pass,52,17,69,PROJECT AND VIVA VOCE ,Pass,213,50,263
M1615629, College : 6210  -  VIDHYAPRASARAK SOCIETY S COLLEGE OF B.C.A.  BAGALKOT,N.C.L,--   ,SOFTWARE PRACTICES AND TESTING ,Pass,47,10,57,BUSINESS INTELLIGENCE ,Pass,38,9,47,J2EE ,Pass,32,12,44,J2EE AND SOFTWARE TESTING LABORATORY,Pass,50,14,64,PROJECT AND VIVA VOCE ,Pass,210,53,263
M1615630, College : 6210  -  VIDHYAPRASARAK SOCIETY S COLLEGE OF B.C.A.  BAGALKOT,N.C.L,--   ,SOFTWARE PRACTICES AND TESTING ,Pass,43,10,53,BUSINESS INTELLIGENCE ,Pass,33,9,42,J2EE ,Pass,39,10,49,J2EE AND SOFTWARE TESTING LABORATORY,Pass,50,14,64,PROJECT AND VIVA VOCE ,Pass,195,55,250
M1615631, College : 6210  -  VIDHYAPRASARAK SOCIETY S COLLEGE OF B.C.A.  BAGALKOT,FAIL,57.86,SOFTWARE PRACTICES AND TESTING ,Pass,32,10,42,BUSINESS INTELLIGENCE ,Fail,7,10,17,J2EE ,Pass,32,10,42,J2EE AND SOFTWARE TESTING LABORATORY,Pass,50,14,64,PROJECT AND VIVA VOCE ,Pass,200,40,240
M1615632, College : 6210  -  VIDHYAPRASARAK SOCIETY S COLLEGE OF B.C.A.  BAGALKOT,N.C.L,--   ,SOFTWARE PRACTICES AND TESTING ,Pass,43,10,53,BUSINESS INTELLIGENCE ,Pass,34,10,44,J2EE ,Pass,32,10,42,J2EE AND SOFTWARE TESTING LABORATORY,Pass,50,14,64,PROJECT AND VIVA VOCE ,Pass,210,55,265
M1615633, College : 6210  -  VIDHYAPRASARAK SOCIETY S COLLEGE OF B.C.A.  BAGALKOT,DISTI,86.24,SOFTWARE PRACTICES AND TESTING ,Pass,71,17,88,BUSINESS INTELLIGENCE ,Pass,59,16,75,J2EE ,Pass,54,17,71,J2EE AND SOFTWARE TESTING LABORATORY,Pass,78,20,98,PROJECT AND VIVA VOCE ,Pass,231,60,291
M1615634, College : 6210  -  VIDHYAPRASARAK SOCIETY S COLLEGE OF B.C.A.  BAGALKOT,DISTI,70,SOFTWARE PRACTICES AND TESTING ,Pass,62,18,80,BUSINESS INTELLIGENCE ,Pass,49,15,64,J2EE ,Pass,39,16,55,J2EE AND SOFTWARE TESTING LABORATORY,Pass,63,18,81,PROJECT AND VIVA VOCE ,Pass,220,60,280
M1615636, College : 6210  -  VIDHYAPRASARAK SOCIETY S COLLEGE OF B.C.A.  BAGALKOT,DISTI,88.95,SOFTWARE PRACTICES AND TESTING ,Pass,75,20,95,BUSINESS INTELLIGENCE ,Pass,75,20,95,J2EE ,Pass,66,20,86,J2EE AND SOFTWARE TESTING LABORATORY,Pass,74,20,94,PROJECT AND VIVA VOCE ,Pass,220,60,280
M1615637, College : 6210  -  VIDHYAPRASARAK SOCIETY S COLLEGE OF B.C.A.  BAGALKOT,DISTI,75.59,SOFTWARE PRACTICES AND TESTING ,Pass,61,20,81,BUSINESS INTELLIGENCE ,Pass,69,16,85,J2EE ,Pass,47,16,63,J2EE AND SOFTWARE TESTING LABORATORY,Pass,55,18,73,PROJECT AND VIVA VOCE ,Pass,211,52,263
M1615638, College : 6210  -  VIDHYAPRASARAK SOCIETY S COLLEGE OF B.C.A.  BAGALKOT,N.C.L,--   ,SOFTWARE PRACTICES AND TESTING ,Pass,60,18,78,BUSINESS INTELLIGENCE ,Pass,62,17,79,J2EE ,Pass,35,19,54,J2EE AND SOFTWARE TESTING LABORATORY,Pass,70,18,88,PROJECT AND VIVA VOCE ,Pass,218,58,276
M1615639, College : 6210  -  VIDHYAPRASARAK SOCIETY S COLLEGE OF B.C.A.  BAGALKOT,N.C.L,--   ,SOFTWARE PRACTICES AND TESTING ,Pass,52,17,69,BUSINESS INTELLIGENCE ,Pass,58,13,71,J2EE ,Pass,44,18,62,J2EE AND SOFTWARE TESTING LABORATORY,Pass,70,17,87,PROJECT AND VIVA VOCE ,Pass,200,60,260
M1615641, College : 6210  -  VIDHYAPRASARAK SOCIETY S COLLEGE OF B.C.A.  BAGALKOT,1ST C,64.19,SOFTWARE PRACTICES AND TESTING ,Pass,52,10,62,BUSINESS INTELLIGENCE ,Pass,65,11,76,J2EE ,Pass,55,12,67,J2EE AND SOFTWARE TESTING LABORATORY,Pass,50,17,67,PROJECT AND VIVA VOCE ,Pass,205,55,260
M1615642, College : 6210  -  VIDHYAPRASARAK SOCIETY S COLLEGE OF B.C.A.  BAGALKOT,DISTI,70,SOFTWARE PRACTICES AND TESTING ,Pass,46,19,65,BUSINESS INTELLIGENCE ,Pass,64,13,77,J2EE ,Pass,44,20,64,J2EE AND SOFTWARE TESTING LABORATORY,Pass,68,19,87,PROJECT AND VIVA VOCE ,Pass,222,60,282
M1615643, College : 6210  -  VIDHYAPRASARAK SOCIETY S COLLEGE OF B.C.A.  BAGALKOT,DISTI,83.59,SOFTWARE PRACTICES AND TESTING ,Pass,61,15,76,BUSINESS INTELLIGENCE ,Pass,74,19,93,J2EE ,Pass,59,20,79,J2EE AND SOFTWARE TESTING LABORATORY,Pass,80,20,100,PROJECT AND VIVA VOCE ,Pass,215,60,275
M1615644, College : 6210  -  VIDHYAPRASARAK SOCIETY S COLLEGE OF B.C.A.  BAGALKOT,N.C.L,--   ,SOFTWARE PRACTICES AND TESTING ,Pass,32,14,46,BUSINESS INTELLIGENCE ,Pass,32,12,44,J2EE ,Pass,34,14,48,J2EE AND SOFTWARE TESTING LABORATORY,Pass,50,17,67,PROJECT AND VIVA VOCE ,Pass,195,57,252
M1615646, College : 6210  -  VIDHYAPRASARAK SOCIETY S COLLEGE OF B.C.A.  BAGALKOT,N.C.L,--   ,SOFTWARE PRACTICES AND TESTING ,Pass,49,13,62,BUSINESS INTELLIGENCE ,Pass,37,12,49,J2EE ,Pass,44,12,56,J2EE AND SOFTWARE TESTING LABORATORY,Pass,50,17,67,PROJECT AND VIVA VOCE ,Pass,208,55,263
M1615647, College : 6210  -  VIDHYAPRASARAK SOCIETY S COLLEGE OF B.C.A.  BAGALKOT,N.C.L,--   ,SOFTWARE PRACTICES AND TESTING ,Pass,32,10,42,BUSINESS INTELLIGENCE ,Pass,36,10,46,J2EE ,Pass,35,15,50,J2EE AND SOFTWARE TESTING LABORATORY,Pass,51,17,68,PROJECT AND VIVA VOCE ,Pass,208,52,260
M1615649, College : 6210  -  VIDHYAPRASARAK SOCIETY S COLLEGE OF B.C.A.  BAGALKOT,DISTI,72.24,SOFTWARE PRACTICES AND TESTING ,Pass,67,20,87,BUSINESS INTELLIGENCE ,Pass,69,15,84,J2EE ,Pass,51,17,68,J2EE AND SOFTWARE TESTING LABORATORY,Pass,52,18,70,PROJECT AND VIVA VOCE ,Pass,220,60,280
M1615650, College : 6210  -  VIDHYAPRASARAK SOCIETY S COLLEGE OF B.C.A.  BAGALKOT,1ST C,69.05,SOFTWARE PRACTICES AND TESTING ,Pass,52,18,70,BUSINESS INTELLIGENCE ,Pass,63,15,78,J2EE ,Pass,58,17,75,J2EE AND SOFTWARE TESTING LABORATORY,Pass,52,18,70,PROJECT AND VIVA VOCE ,Pass,218,58,276
M1615651, College : 6210  -  VIDHYAPRASARAK SOCIETY S COLLEGE OF B.C.A.  BAGALKOT,DISTI,74.7,SOFTWARE PRACTICES AND TESTING ,Pass,62,15,77,BUSINESS INTELLIGENCE ,Pass,61,13,74,J2EE ,Pass,40,15,55,J2EE AND SOFTWARE TESTING LABORATORY,Pass,67,18,85,PROJECT AND VIVA VOCE ,Pass,200,55,255
M1615652, College : 6210  -  VIDHYAPRASARAK SOCIETY S COLLEGE OF B.C.A.  BAGALKOT,N.C.L,--   ,SOFTWARE PRACTICES AND TESTING ,Pass,61,12,73,BUSINESS INTELLIGENCE ,Pass,61,15,76,J2EE ,Pass,32,15,47,J2EE AND SOFTWARE TESTING LABORATORY,Pass,50,18,68,PROJECT AND VIVA VOCE ,Pass,210,50,260
M1615653, College : 6210  -  VIDHYAPRASARAK SOCIETY S COLLEGE OF B.C.A.  BAGALKOT,N.C.L,--   ,SOFTWARE PRACTICES AND TESTING ,Pass,59,18,77,BUSINESS INTELLIGENCE ,Pass,52,17,69,J2EE ,Pass,32,18,50,J2EE AND SOFTWARE TESTING LABORATORY,Pass,60,17,77,PROJECT AND VIVA VOCE ,Pass,220,54,274
M1615654, College : 6210  -  VIDHYAPRASARAK SOCIETY S COLLEGE OF B.C.A.  BAGALKOT,DISTI,75.3,SOFTWARE PRACTICES AND TESTING ,Pass,62,17,79,BUSINESS INTELLIGENCE ,Pass,60,16,76,J2EE ,Pass,53,20,73,J2EE AND SOFTWARE TESTING LABORATORY,Pass,78,20,98,PROJECT AND VIVA VOCE ,Pass,215,54,269
M1615655, College : 6210  -  VIDHYAPRASARAK SOCIETY S COLLEGE OF B.C.A.  BAGALKOT,N.C.L,--   ,SOFTWARE PRACTICES AND TESTING ,Pass,57,18,75,BUSINESS INTELLIGENCE ,Pass,49,15,64,J2EE ,Pass,39,18,57,J2EE AND SOFTWARE TESTING LABORATORY,Pass,50,18,68,PROJECT AND VIVA VOCE ,Pass,215,58,273
M1615656, College : 6210  -  VIDHYAPRASARAK SOCIETY S COLLEGE OF B.C.A.  BAGALKOT,DISTI,82.46,SOFTWARE PRACTICES AND TESTING ,Pass,58,19,77,BUSINESS INTELLIGENCE ,Pass,61,18,79,J2EE ,Pass,62,20,82,J2EE AND SOFTWARE TESTING LABORATORY,Pass,73,20,93,PROJECT AND VIVA VOCE ,Pass,218,58,276
M1615657, College : 6210  -  VIDHYAPRASARAK SOCIETY S COLLEGE OF B.C.A.  BAGALKOT,FAIL,61.43,SOFTWARE PRACTICES AND TESTING ,Pass,33,14,47,BUSINESS INTELLIGENCE ,Pass,43,9,52,J2EE ,Fail,16,12,28,J2EE AND SOFTWARE TESTING LABORATORY,Pass,41,16,57,PROJECT AND VIVA VOCE ,Pass,190,56,246
M1615658, College : 6210  -  VIDHYAPRASARAK SOCIETY S COLLEGE OF B.C.A.  BAGALKOT,DISTI,75.32,SOFTWARE PRACTICES AND TESTING ,Pass,52,16,68,BUSINESS INTELLIGENCE ,Pass,58,11,69,J2EE ,Pass,48,15,63,J2EE AND SOFTWARE TESTING LABORATORY,Pass,69,18,87,PROJECT AND VIVA VOCE ,Pass,190,58,248
M1615659, College : 6210  -  VIDHYAPRASARAK SOCIETY S COLLEGE OF B.C.A.  BAGALKOT,N.C.L,--   ,SOFTWARE PRACTICES AND TESTING ,Pass,32,14,46,BUSINESS INTELLIGENCE ,Pass,47,10,57,J2EE ,Pass,42,12,54,J2EE AND SOFTWARE TESTING LABORATORY,Pass,54,16,70,PROJECT AND VIVA VOCE ,Pass,210,50,260
M1615661, College : 6210  -  VIDHYAPRASARAK SOCIETY S COLLEGE OF B.C.A.  BAGALKOT,DISTI,79.16,SOFTWARE PRACTICES AND TESTING ,Pass,65,20,85,BUSINESS INTELLIGENCE ,Pass,59,16,75,J2EE ,Pass,49,20,69,J2EE AND SOFTWARE TESTING LABORATORY,Pass,66,18,84,PROJECT AND VIVA VOCE ,Pass,212,55,267
M1615662, College : 6210  -  VIDHYAPRASARAK SOCIETY S COLLEGE OF B.C.A.  BAGALKOT,DISTI,77.78,SOFTWARE PRACTICES AND TESTING ,Pass,70,18,88,BUSINESS INTELLIGENCE ,Pass,59,13,72,J2EE ,Pass,55,15,70,J2EE AND SOFTWARE TESTING LABORATORY,Pass,67,18,85,PROJECT AND VIVA VOCE ,Pass,212,55,267
M1615663, College : 6210  -  VIDHYAPRASARAK SOCIETY S COLLEGE OF B.C.A.  BAGALKOT,DISTI,82.05,SOFTWARE PRACTICES AND TESTING ,Pass,67,19,86,BUSINESS INTELLIGENCE ,Pass,66,17,83,J2EE ,Pass,68,19,87,J2EE AND SOFTWARE TESTING LABORATORY,Pass,80,20,100,PROJECT AND VIVA VOCE ,Pass,228,60,288
M1615664, College : 6210  -  VIDHYAPRASARAK SOCIETY S COLLEGE OF B.C.A.  BAGALKOT,N.C.L,--   ,SOFTWARE PRACTICES AND TESTING ,Pass,32,12,44,BUSINESS INTELLIGENCE ,Pass,53,9,62,J2EE ,Pass,32,12,44,J2EE AND SOFTWARE TESTING LABORATORY,Pass,51,17,68,PROJECT AND VIVA VOCE ,Pass,200,56,256
M1615665, College : 6210  -  VIDHYAPRASARAK SOCIETY S COLLEGE OF B.C.A.  BAGALKOT,DISTI,76.38,SOFTWARE PRACTICES AND TESTING ,Pass,65,18,83,BUSINESS INTELLIGENCE ,Pass,69,18,87,J2EE ,Pass,51,20,71,J2EE AND SOFTWARE TESTING LABORATORY,Pass,55,20,75,PROJECT AND VIVA VOCE ,Pass,210,56,266
M1615666, College : 6210  -  VIDHYAPRASARAK SOCIETY S COLLEGE OF B.C.A.  BAGALKOT,N.C.L,--   ,SOFTWARE PRACTICES AND TESTING ,Pass,38,15,53,BUSINESS INTELLIGENCE ,Pass,46,11,57,J2EE ,Pass,32,16,48,J2EE AND SOFTWARE TESTING LABORATORY,Pass,51,17,68,PROJECT AND VIVA VOCE ,Pass,205,54,259
M1615667, College : 6210  -  VIDHYAPRASARAK SOCIETY S COLLEGE OF B.C.A.  BAGALKOT,N.C.L,--   ,SOFTWARE PRACTICES AND TESTING ,Pass,32,16,48,BUSINESS INTELLIGENCE ,Pass,41,14,55,J2EE ,Pass,33,16,49,J2EE AND SOFTWARE TESTING LABORATORY,Pass,52,16,68,PROJECT AND VIVA VOCE ,Pass,210,60,270
M1615668, College : 6210  -  VIDHYAPRASARAK SOCIETY S COLLEGE OF B.C.A.  BAGALKOT,DISTI,72.24,SOFTWARE PRACTICES AND TESTING ,Pass,60,18,78,BUSINESS INTELLIGENCE ,Pass,68,15,83,J2EE ,Pass,38,14,52,J2EE AND SOFTWARE TESTING LABORATORY,Pass,40,17,57,PROJECT AND VIVA VOCE ,Pass,210,54,264
M1615669, College : 6210  -  VIDHYAPRASARAK SOCIETY S COLLEGE OF B.C.A.  BAGALKOT,N.C.L,--   ,SOFTWARE PRACTICES AND TESTING ,Pass,74,20,94,BUSINESS INTELLIGENCE ,Pass,62,20,82,J2EE ,Pass,62,20,82,J2EE AND SOFTWARE TESTING LABORATORY,Pass,76,20,96,PROJECT AND VIVA VOCE ,Pass,220,58,278
M1615670, College : 6210  -  VIDHYAPRASARAK SOCIETY S COLLEGE OF B.C.A.  BAGALKOT,FAIL,65.14,SOFTWARE PRACTICES AND TESTING ,Pass,40,15,55,BUSINESS INTELLIGENCE ,Pass,33,12,45,J2EE ,Fail,15,15,30,J2EE AND SOFTWARE TESTING LABORATORY,Pass,51,17,68,PROJECT AND VIVA VOCE ,Pass,208,50,258
M1615671, College : 6210  -  VIDHYAPRASARAK SOCIETY S COLLEGE OF B.C.A.  BAGALKOT,N.C.L,--   ,SOFTWARE PRACTICES AND TESTING ,Pass,57,18,75,BUSINESS INTELLIGENCE ,Pass,64,18,82,J2EE ,Pass,58,18,76,J2EE AND SOFTWARE TESTING LABORATORY,Pass,64,18,82,PROJECT AND VIVA VOCE ,Pass,223,54,277
M1615672, College : 6210  -  VIDHYAPRASARAK SOCIETY S COLLEGE OF B.C.A.  BAGALKOT,FAIL,73.43,SOFTWARE PRACTICES AND TESTING ,Pass,54,19,73,BUSINESS INTELLIGENCE ,Pass,49,16,65,J2EE ,Fail,17,15,32,J2EE AND SOFTWARE TESTING LABORATORY,Pass,60,20,80,PROJECT AND VIVA VOCE ,Pass,210,54,264
M1615674, College : 6210  -  VIDHYAPRASARAK SOCIETY S COLLEGE OF B.C.A.  BAGALKOT,FAIL,64.86,SOFTWARE PRACTICES AND TESTING ,Pass,40,12,52,BUSINESS INTELLIGENCE ,Pass,38,9,47,J2EE ,Fail,7,15,22,J2EE AND SOFTWARE TESTING LABORATORY,Pass,50,17,67,PROJECT AND VIVA VOCE ,Pass,208,58,266
M1615675, College : 6210  -  VIDHYAPRASARAK SOCIETY S COLLEGE OF B.C.A.  BAGALKOT,N.C.L,--   ,SOFTWARE PRACTICES AND TESTING ,Pass,41,12,53,BUSINESS INTELLIGENCE ,Pass,38,10,48,J2EE ,Pass,32,14,46,J2EE AND SOFTWARE TESTING LABORATORY,Pass,50,16,66,PROJECT AND VIVA VOCE ,Pass,165,52,217
M1615676, College : 6210  -  VIDHYAPRASARAK SOCIETY S COLLEGE OF B.C.A.  BAGALKOT,N.C.L,--   ,SOFTWARE PRACTICES AND TESTING ,Pass,55,17,72,BUSINESS INTELLIGENCE ,Pass,47,10,57,J2EE ,Pass,43,17,60,J2EE AND SOFTWARE TESTING LABORATORY,Pass,50,19,69,PROJECT AND VIVA VOCE ,Pass,218,58,276
M1615677, College : 6210  -  VIDHYAPRASARAK SOCIETY S COLLEGE OF B.C.A.  BAGALKOT,N.C.L,--   ,SOFTWARE PRACTICES AND TESTING ,Pass,54,15,69,BUSINESS INTELLIGENCE ,Pass,57,13,70,J2EE ,Pass,32,16,48,J2EE AND SOFTWARE TESTING LABORATORY,Pass,50,17,67,PROJECT AND VIVA VOCE ,Pass,215,55,270
M1615678, College : 6210  -  VIDHYAPRASARAK SOCIETY S COLLEGE OF B.C.A.  BAGALKOT,FAIL,63,SOFTWARE PRACTICES AND TESTING ,Pass,42,12,54,BUSINESS INTELLIGENCE ,Pass,32,11,43,J2EE ,Fail,3,14,17,J2EE AND SOFTWARE TESTING LABORATORY,Pass,45,17,62,PROJECT AND VIVA VOCE ,Pass,210,55,265
M1615679, College : 6210  -  VIDHYAPRASARAK SOCIETY S COLLEGE OF B.C.A.  BAGALKOT,N.C.L,--   ,SOFTWARE PRACTICES AND TESTING ,Pass,61,16,77,BUSINESS INTELLIGENCE ,Pass,66,13,79,J2EE ,Pass,39,14,53,J2EE AND SOFTWARE TESTING LABORATORY,Pass,51,17,68,PROJECT AND VIVA VOCE ,Pass,210,54,264
M1615681, College : 6210  -  VIDHYAPRASARAK SOCIETY S COLLEGE OF B.C.A.  BAGALKOT,DISTI,71.24,SOFTWARE PRACTICES AND TESTING ,Pass,71,17,88,BUSINESS INTELLIGENCE ,Pass,70,18,88,J2EE ,Pass,41,14,55,J2EE AND SOFTWARE TESTING LABORATORY,Pass,62,18,80,PROJECT AND VIVA VOCE ,Pass,215,60,275
M1615682, College : 6210  -  VIDHYAPRASARAK SOCIETY S COLLEGE OF B.C.A.  BAGALKOT,N.C.L,--   ,SOFTWARE PRACTICES AND TESTING ,Pass,58,17,75,BUSINESS INTELLIGENCE ,Pass,45,17,62,J2EE ,Pass,32,14,46,J2EE AND SOFTWARE TESTING LABORATORY,Pass,65,18,83,PROJECT AND VIVA VOCE ,Pass,215,60,275
M1615684, College : 6210  -  VIDHYAPRASARAK SOCIETY S COLLEGE OF B.C.A.  BAGALKOT,N.C.L,--   ,SOFTWARE PRACTICES AND TESTING ,Pass,71,16,87,BUSINESS INTELLIGENCE ,Pass,54,15,69,J2EE ,Pass,47,19,66,J2EE AND SOFTWARE TESTING LABORATORY,Pass,60,18,78,PROJECT AND VIVA VOCE ,Pass,215,50,265
M1615685, College : 6210  -  VIDHYAPRASARAK SOCIETY S COLLEGE OF B.C.A.  BAGALKOT,DISTI,90.76,SOFTWARE PRACTICES AND TESTING ,Pass,70,20,90,BUSINESS INTELLIGENCE ,Pass,74,20,94,J2EE ,Pass,74,20,94,J2EE AND SOFTWARE TESTING LABORATORY,Pass,78,20,98,PROJECT AND VIVA VOCE ,Pass,232,58,290
M1615686, College : 6210  -  VIDHYAPRASARAK SOCIETY S COLLEGE OF B.C.A.  BAGALKOT,N.C.L,--   ,SOFTWARE PRACTICES AND TESTING ,Pass,50,18,68,BUSINESS INTELLIGENCE ,Pass,56,18,74,J2EE ,Pass,41,18,59,J2EE AND SOFTWARE TESTING LABORATORY,Pass,67,18,85,PROJECT AND VIVA VOCE ,Pass,224,58,282
M1615687, College : 6210  -  VIDHYAPRASARAK SOCIETY S COLLEGE OF B.C.A.  BAGALKOT,1ST C,66.38,SOFTWARE PRACTICES AND TESTING ,Pass,48,16,64,BUSINESS INTELLIGENCE ,Pass,41,13,54,J2EE ,Pass,32,14,46,J2EE AND SOFTWARE TESTING LABORATORY,Pass,73,18,91,PROJECT AND VIVA VOCE ,Pass,220,58,278
M1615688, College : 6210  -  VIDHYAPRASARAK SOCIETY S COLLEGE OF B.C.A.  BAGALKOT,DISTI,74.35,SOFTWARE PRACTICES AND TESTING ,Pass,50,16,66,BUSINESS INTELLIGENCE ,Pass,50,17,67,J2EE ,Pass,57,19,76,J2EE AND SOFTWARE TESTING LABORATORY,Pass,60,18,78,PROJECT AND VIVA VOCE ,Pass,215,58,273
M1615689, College : 6210  -  VIDHYAPRASARAK SOCIETY S COLLEGE OF B.C.A.  BAGALKOT,N.C.L,--   ,SOFTWARE PRACTICES AND TESTING ,Pass,61,12,73,BUSINESS INTELLIGENCE ,Pass,49,16,65,J2EE ,Pass,48,15,63,J2EE AND SOFTWARE TESTING LABORATORY,Pass,63,17,80,PROJECT AND VIVA VOCE ,Pass,215,60,275
M1615690, College : 6210  -  VIDHYAPRASARAK SOCIETY S COLLEGE OF B.C.A.  BAGALKOT,DISTI,87.05,SOFTWARE PRACTICES AND TESTING ,Pass,73,20,93,BUSINESS INTELLIGENCE ,Pass,76,19,95,J2EE ,Pass,70,20,90,J2EE AND SOFTWARE TESTING LABORATORY,Pass,80,20,100,PROJECT AND VIVA VOCE ,Pass,234,60,294
M1615691, College : 6210  -  VIDHYAPRASARAK SOCIETY S COLLEGE OF B.C.A.  BAGALKOT,N.C.L,--   ,SOFTWARE PRACTICES AND TESTING ,Pass,43,16,59,BUSINESS INTELLIGENCE ,Pass,61,16,77,J2EE ,Pass,45,15,60,J2EE AND SOFTWARE TESTING LABORATORY,Pass,58,18,76,PROJECT AND VIVA VOCE ,Pass,208,54,262
M1615692, College : 6210  -  VIDHYAPRASARAK SOCIETY S COLLEGE OF B.C.A.  BAGALKOT,N.C.L,--   ,SOFTWARE PRACTICES AND TESTING ,Pass,39,12,51,BUSINESS INTELLIGENCE ,Pass,48,13,61,J2EE ,Pass,40,14,54,J2EE AND SOFTWARE TESTING LABORATORY,Pass,45,17,62,PROJECT AND VIVA VOCE ,Pass,200,40,240
M1615693, College : 6210  -  VIDHYAPRASARAK SOCIETY S COLLEGE OF B.C.A.  BAGALKOT,N.C.L,--   ,SOFTWARE PRACTICES AND TESTING ,Pass,54,12,66,BUSINESS INTELLIGENCE ,Pass,50,14,64,J2EE ,Pass,55,14,69,J2EE AND SOFTWARE TESTING LABORATORY,Pass,55,17,72,PROJECT AND VIVA VOCE ,Pass,215,54,269
M1615695, College : 6210  -  VIDHYAPRASARAK SOCIETY S COLLEGE OF B.C.A.  BAGALKOT,DISTI,92.73,SOFTWARE PRACTICES AND TESTING ,Pass,72,20,92,BUSINESS INTELLIGENCE ,Pass,79,20,99,J2EE ,Pass,75,20,95,J2EE AND SOFTWARE TESTING LABORATORY,Pass,80,20,100,PROJECT AND VIVA VOCE ,Pass,232,60,292
M1615696, College : 6210  -  VIDHYAPRASARAK SOCIETY S COLLEGE OF B.C.A.  BAGALKOT,N.C.L,--   ,SOFTWARE PRACTICES AND TESTING ,Pass,44,12,56,BUSINESS INTELLIGENCE ,Pass,32,15,47,J2EE ,Pass,34,14,48,J2EE AND SOFTWARE TESTING LABORATORY,Pass,50,18,68,PROJECT AND VIVA VOCE ,Pass,210,59,269
M1615697, College : 6210  -  VIDHYAPRASARAK SOCIETY S COLLEGE OF B.C.A.  BAGALKOT,N.C.L,--   ,SOFTWARE PRACTICES AND TESTING ,Pass,45,12,57,BUSINESS INTELLIGENCE ,Pass,62,11,73,J2EE ,Pass,48,14,62,J2EE AND SOFTWARE TESTING LABORATORY,Pass,49,16,65,PROJECT AND VIVA VOCE ,Pass,204,56,260
M1615698, College : 6210  -  VIDHYAPRASARAK SOCIETY S COLLEGE OF B.C.A.  BAGALKOT,DISTI,70.49,SOFTWARE PRACTICES AND TESTING ,Pass,58,16,74,BUSINESS INTELLIGENCE ,Pass,60,15,75,J2EE ,Pass,57,16,73,J2EE AND SOFTWARE TESTING LABORATORY,Pass,48,16,64,PROJECT AND VIVA VOCE ,Pass,210,56,266
M1615699, College : 6210  -  VIDHYAPRASARAK SOCIETY S COLLEGE OF B.C.A.  BAGALKOT,N.C.L,--   ,SOFTWARE PRACTICES AND TESTING ,Pass,43,15,58,BUSINESS INTELLIGENCE ,Pass,53,12,65,J2EE ,Pass,51,15,66,J2EE AND SOFTWARE TESTING LABORATORY,Pass,50,16,66,PROJECT AND VIVA VOCE ,Pass,210,60,270
M1615700, College : 6210  -  VIDHYAPRASARAK SOCIETY S COLLEGE OF B.C.A.  BAGALKOT,DISTI,73.27,SOFTWARE PRACTICES AND TESTING ,Pass,60,20,80,BUSINESS INTELLIGENCE ,Pass,68,18,86,J2EE ,Pass,50,15,65,J2EE AND SOFTWARE TESTING LABORATORY,Pass,69,20,89,PROJECT AND VIVA VOCE ,Pass,208,60,268
M1615701, College : 6210  -  VIDHYAPRASARAK SOCIETY S COLLEGE OF B.C.A.  BAGALKOT,N.C.L,--   ,SOFTWARE PRACTICES AND TESTING ,Pass,66,18,84,BUSINESS INTELLIGENCE ,Pass,77,17,94,J2EE ,Pass,52,19,71,J2EE AND SOFTWARE TESTING LABORATORY,Pass,60,19,79,PROJECT AND VIVA VOCE ,Pass,218,45,263
M1615702, College : 6210  -  VIDHYAPRASARAK SOCIETY S COLLEGE OF B.C.A.  BAGALKOT,DISTI,75.59,SOFTWARE PRACTICES AND TESTING ,Pass,60,16,76,BUSINESS INTELLIGENCE ,Pass,58,16,74,J2EE ,Pass,45,19,64,J2EE AND SOFTWARE TESTING LABORATORY,Pass,66,20,86,PROJECT AND VIVA VOCE ,Pass,217,60,277
M1615703, College : 6210  -  VIDHYAPRASARAK SOCIETY S COLLEGE OF B.C.A.  BAGALKOT,DISTI,71.78,SOFTWARE PRACTICES AND TESTING ,Pass,51,18,69,BUSINESS INTELLIGENCE ,Pass,70,18,88,J2EE ,Pass,57,19,76,J2EE AND SOFTWARE TESTING LABORATORY,Pass,50,18,68,PROJECT AND VIVA VOCE ,Pass,210,56,266
M1615704, College : 6210  -  VIDHYAPRASARAK SOCIETY S COLLEGE OF B.C.A.  BAGALKOT,DISTI,83.97,SOFTWARE PRACTICES AND TESTING ,Pass,67,20,87,BUSINESS INTELLIGENCE ,Pass,55,18,73,J2EE ,Pass,60,20,80,J2EE AND SOFTWARE TESTING LABORATORY,Pass,70,20,90,PROJECT AND VIVA VOCE ,Pass,234,60,294
M1615705, College : 6210  -  VIDHYAPRASARAK SOCIETY S COLLEGE OF B.C.A.  BAGALKOT,DISTI,82.22,SOFTWARE PRACTICES AND TESTING ,Pass,66,19,85,BUSINESS INTELLIGENCE ,Pass,68,18,86,J2EE ,Pass,68,19,87,J2EE AND SOFTWARE TESTING LABORATORY,Pass,55,17,72,PROJECT AND VIVA VOCE ,Pass,218,56,274
M1615706, College : 6210  -  VIDHYAPRASARAK SOCIETY S COLLEGE OF B.C.A.  BAGALKOT,DISTI,78.43,SOFTWARE PRACTICES AND TESTING ,Pass,71,17,88,BUSINESS INTELLIGENCE ,Pass,60,19,79,J2EE ,Pass,45,19,64,J2EE AND SOFTWARE TESTING LABORATORY,Pass,55,18,73,PROJECT AND VIVA VOCE ,Pass,220,59,279
M1615707, College : 6210  -  VIDHYAPRASARAK SOCIETY S COLLEGE OF B.C.A.  BAGALKOT,N.C.L,--   ,SOFTWARE PRACTICES AND TESTING ,Pass,43,18,61,BUSINESS INTELLIGENCE ,Pass,54,12,66,J2EE ,Pass,36,17,53,J2EE AND SOFTWARE TESTING LABORATORY,Pass,55,19,74,PROJECT AND VIVA VOCE ,Pass,215,50,265
M1615708, College : 6210  -  VIDHYAPRASARAK SOCIETY S COLLEGE OF B.C.A.  BAGALKOT,DISTI,77.65,SOFTWARE PRACTICES AND TESTING ,Pass,55,17,72,BUSINESS INTELLIGENCE ,Pass,67,13,80,J2EE ,Pass,48,18,66,J2EE AND SOFTWARE TESTING LABORATORY,Pass,55,18,73,PROJECT AND VIVA VOCE ,Pass,212,56,268
M1615709, College : 6210  -  VIDHYAPRASARAK SOCIETY S COLLEGE OF B.C.A.  BAGALKOT,DISTI,88.27,SOFTWARE PRACTICES AND TESTING ,Pass,67,20,87,BUSINESS INTELLIGENCE ,Pass,74,19,93,J2EE ,Pass,42,20,62,J2EE AND SOFTWARE TESTING LABORATORY,Pass,70,20,90,PROJECT AND VIVA VOCE ,Pass,234,60,294
M1615710, College : 6210  -  VIDHYAPRASARAK SOCIETY S COLLEGE OF B.C.A.  BAGALKOT,DISTI,75.41,SOFTWARE PRACTICES AND TESTING ,Pass,54,19,73,BUSINESS INTELLIGENCE ,Pass,53,16,69,J2EE ,Pass,34,18,52,J2EE AND SOFTWARE TESTING LABORATORY,Pass,53,17,70,PROJECT AND VIVA VOCE ,Pass,218,55,273
M1615712, College : 6210  -  VIDHYAPRASARAK SOCIETY S COLLEGE OF B.C.A.  BAGALKOT,N.C.L,--   ,SOFTWARE PRACTICES AND TESTING ,Pass,57,17,74,BUSINESS INTELLIGENCE ,Pass,66,17,83,J2EE ,Pass,37,17,54,J2EE AND SOFTWARE TESTING LABORATORY,Pass,58,17,75,PROJECT AND VIVA VOCE ,Pass,210,54,264
M1615713, College : 6210  -  VIDHYAPRASARAK SOCIETY S COLLEGE OF B.C.A.  BAGALKOT,DISTI,71.92,SOFTWARE PRACTICES AND TESTING ,Pass,62,16,78,BUSINESS INTELLIGENCE ,Pass,65,14,79,J2EE ,Pass,32,15,47,J2EE AND SOFTWARE TESTING LABORATORY,Pass,51,17,68,PROJECT AND VIVA VOCE ,Pass,190,57,247
M1615714, College : 6210  -  VIDHYAPRASARAK SOCIETY S COLLEGE OF B.C.A.  BAGALKOT,DISTI,84.76,SOFTWARE PRACTICES AND TESTING ,Pass,72,17,89,BUSINESS INTELLIGENCE ,Pass,75,17,92,J2EE ,Pass,51,20,71,J2EE AND SOFTWARE TESTING LABORATORY,Pass,80,20,100,PROJECT AND VIVA VOCE ,Pass,216,45,261
M1615716, College : 6210  -  VIDHYAPRASARAK SOCIETY S COLLEGE OF B.C.A.  BAGALKOT,N.C.L,--   ,SOFTWARE PRACTICES AND TESTING ,Pass,54,18,72,BUSINESS INTELLIGENCE ,Pass,54,18,72,J2EE ,Pass,43,18,61,J2EE AND SOFTWARE TESTING LABORATORY,Pass,63,18,81,PROJECT AND VIVA VOCE ,Pass,216,55,271
M1615717, College : 6210  -  VIDHYAPRASARAK SOCIETY S COLLEGE OF B.C.A.  BAGALKOT,N.C.L,--   ,SOFTWARE PRACTICES AND TESTING ,Pass,50,18,68,BUSINESS INTELLIGENCE ,Pass,55,17,72,J2EE ,Pass,43,17,60,J2EE AND SOFTWARE TESTING LABORATORY,Pass,61,18,79,PROJECT AND VIVA VOCE ,Pass,217,56,273
M1615718, College : 6210  -  VIDHYAPRASARAK SOCIETY S COLLEGE OF B.C.A.  BAGALKOT,FAIL,67.57,SOFTWARE PRACTICES AND TESTING ,Pass,37,15,52,BUSINESS INTELLIGENCE ,Pass,35,12,47,J2EE ,Fail,21,15,36,J2EE AND SOFTWARE TESTING LABORATORY,Pass,45,16,61,PROJECT AND VIVA VOCE ,Pass,218,59,277
M1615719, College : 6210  -  VIDHYAPRASARAK SOCIETY S COLLEGE OF B.C.A.  BAGALKOT,N.C.L,--   ,SOFTWARE PRACTICES AND TESTING ,Pass,55,13,68,BUSINESS INTELLIGENCE ,Pass,56,16,72,J2EE ,Pass,35,15,50,J2EE AND SOFTWARE TESTING LABORATORY,Pass,53,18,71,PROJECT AND VIVA VOCE ,Pass,210,40,250
M1616001, College : 6221  -  A. R. JAHAGIRDAR B.C.A. COLLEGE  ILKAL,DISTI,79.22,SOFTWARE PRACTICES AND TESTING ,Pass,50,16,66,BUSINESS INTELLIGENCE ,Pass,61,20,81,J2EE ,Pass,65,17,82,J2EE AND SOFTWARE TESTING LABORATORY,Pass,75,19,94,PROJECT AND VIVA VOCE ,Pass,226,57,283
M1616002, College : 6221  -  A. R. JAHAGIRDAR B.C.A. COLLEGE  ILKAL,DISTI,75.14,SOFTWARE PRACTICES AND TESTING ,Pass,44,19,63,BUSINESS INTELLIGENCE ,Pass,49,20,69,J2EE ,Pass,35,18,53,J2EE AND SOFTWARE TESTING LABORATORY,Pass,72,20,92,PROJECT AND VIVA VOCE ,Pass,225,57,282
M1616003, College : 6221  -  A. R. JAHAGIRDAR B.C.A. COLLEGE  ILKAL,DISTI,77.68,SOFTWARE PRACTICES AND TESTING ,Pass,54,19,73,BUSINESS INTELLIGENCE ,Pass,61,20,81,J2EE ,Pass,47,19,66,J2EE AND SOFTWARE TESTING LABORATORY,Pass,72,20,92,PROJECT AND VIVA VOCE ,Pass,220,58,278
M1616004, College : 6221  -  A. R. JAHAGIRDAR B.C.A. COLLEGE  ILKAL,N.C.L,--   ,SOFTWARE PRACTICES AND TESTING ,Pass,44,18,62,BUSINESS INTELLIGENCE ,Pass,63,20,83,J2EE ,Pass,51,18,69,J2EE AND SOFTWARE TESTING LABORATORY,Pass,75,20,95,PROJECT AND VIVA VOCE ,Pass,205,58,263
M1616006, College : 6221  -  A. R. JAHAGIRDAR B.C.A. COLLEGE  ILKAL,N.C.L,--   ,SOFTWARE PRACTICES AND TESTING ,Pass,50,18,68,BUSINESS INTELLIGENCE ,Pass,62,20,82,J2EE ,Pass,51,18,69,J2EE AND SOFTWARE TESTING LABORATORY,Pass,72,20,92,PROJECT AND VIVA VOCE ,Pass,215,58,273
M1616007, College : 6221  -  A. R. JAHAGIRDAR B.C.A. COLLEGE  ILKAL,N.C.L,--   ,SOFTWARE PRACTICES AND TESTING ,Pass,47,18,65,BUSINESS INTELLIGENCE ,Pass,47,20,67,J2EE ,Pass,35,19,54,J2EE AND SOFTWARE TESTING LABORATORY,Pass,74,20,94,PROJECT AND VIVA VOCE ,Pass,215,58,273
M1616008, College : 6221  -  A. R. JAHAGIRDAR B.C.A. COLLEGE  ILKAL,FAIL,47.29,SOFTWARE PRACTICES AND TESTING ,Fail,Ab.,10,10,BUSINESS INTELLIGENCE ,Fail,Ab.,10,10,J2EE ,Fail,Ab.,8,8,J2EE AND SOFTWARE TESTING LABORATORY,Pass,56,12,68,PROJECT AND VIVA VOCE ,Pass,195,40,235
M1616009, College : 6221  -  A. R. JAHAGIRDAR B.C.A. COLLEGE  ILKAL,DISTI,81.95,SOFTWARE PRACTICES AND TESTING ,Pass,60,20,80,BUSINESS INTELLIGENCE ,Pass,68,20,88,J2EE ,Pass,48,19,67,J2EE AND SOFTWARE TESTING LABORATORY,Pass,75,20,95,PROJECT AND VIVA VOCE ,Pass,230,58,288
M1616011, College : 6221  -  A. R. JAHAGIRDAR B.C.A. COLLEGE  ILKAL,N.C.L,--   ,SOFTWARE PRACTICES AND TESTING ,Pass,34,18,52,BUSINESS INTELLIGENCE ,Pass,55,20,75,J2EE ,Pass,32,19,51,J2EE AND SOFTWARE TESTING LABORATORY,Pass,74,20,94,PROJECT AND VIVA VOCE ,Pass,210,58,268
M1616013, College : 6221  -  A. R. JAHAGIRDAR B.C.A. COLLEGE  ILKAL,DISTI,81.68,SOFTWARE PRACTICES AND TESTING ,Pass,56,20,76,BUSINESS INTELLIGENCE ,Pass,64,20,84,J2EE ,Pass,53,17,70,J2EE AND SOFTWARE TESTING LABORATORY,Pass,70,19,89,PROJECT AND VIVA VOCE ,Pass,230,58,288
M1616014, College : 6221  -  A. R. JAHAGIRDAR B.C.A. COLLEGE  ILKAL,N.C.L,--   ,SOFTWARE PRACTICES AND TESTING ,Pass,61,17,78,BUSINESS INTELLIGENCE ,Pass,51,20,71,J2EE ,Pass,43,17,60,J2EE AND SOFTWARE TESTING LABORATORY,Pass,70,19,89,PROJECT AND VIVA VOCE ,Pass,225,57,282
M1616015, College : 6221  -  A. R. JAHAGIRDAR B.C.A. COLLEGE  ILKAL,FAIL,66.29,SOFTWARE PRACTICES AND TESTING ,Pass,43,16,59,BUSINESS INTELLIGENCE ,Fail,5,20,25,J2EE ,Fail,12,17,29,J2EE AND SOFTWARE TESTING LABORATORY,Pass,70,19,89,PROJECT AND VIVA VOCE ,Pass,205,57,262
M1616016, College : 6221  -  A. R. JAHAGIRDAR B.C.A. COLLEGE  ILKAL,DISTI,74.97,SOFTWARE PRACTICES AND TESTING ,Pass,63,14,77,BUSINESS INTELLIGENCE ,Pass,62,20,82,J2EE ,Pass,53,15,68,J2EE AND SOFTWARE TESTING LABORATORY,Pass,65,18,83,PROJECT AND VIVA VOCE ,Pass,205,55,260
M1616202, College : 6222  -  BLDEA S COMMERCE  BHS ARTS & TGP SCIENCE COLLEGE  JAMAKHANDI,N.C.L,--   ,SOFTWARE PRACTICES AND TESTING ,Pass,32,20,52,BUSINESS INTELLIGENCE ,Pass,52,19,71,J2EE ,Pass,38,19,57,J2EE AND SOFTWARE TESTING LABORATORY,Pass,71,20,91,PROJECT AND VIVA VOCE ,Pass,235,56,291
M1616203, College : 6222  -  BLDEA S COMMERCE  BHS ARTS & TGP SCIENCE COLLEGE  JAMAKHANDI,DISTI,81.43,SOFTWARE PRACTICES AND TESTING ,Pass,57,19,76,BUSINESS INTELLIGENCE ,Pass,68,18,86,J2EE ,Pass,44,19,63,J2EE AND SOFTWARE TESTING LABORATORY,Pass,70,19,89,PROJECT AND VIVA VOCE ,Pass,225,55,280
M1616205, College : 6222  -  BLDEA S COMMERCE  BHS ARTS & TGP SCIENCE COLLEGE  JAMAKHANDI,DISTI,79.57,SOFTWARE PRACTICES AND TESTING ,Pass,40,18,58,BUSINESS INTELLIGENCE ,Pass,60,17,77,J2EE ,Pass,43,17,60,J2EE AND SOFTWARE TESTING LABORATORY,Pass,70,18,88,PROJECT AND VIVA VOCE ,Pass,230,55,285
M1616206, College : 6222  -  BLDEA S COMMERCE  BHS ARTS & TGP SCIENCE COLLEGE  JAMAKHANDI,N.C.L,--   ,SOFTWARE PRACTICES AND TESTING ,Pass,32,16,48,BUSINESS INTELLIGENCE ,Pass,55,16,71,J2EE ,Pass,32,15,47,J2EE AND SOFTWARE TESTING LABORATORY,Pass,68,16,84,PROJECT AND VIVA VOCE ,Pass,220,45,265
M1616207, College : 6222  -  BLDEA S COMMERCE  BHS ARTS & TGP SCIENCE COLLEGE  JAMAKHANDI,DISTI,79.51,SOFTWARE PRACTICES AND TESTING ,Pass,32,17,49,BUSINESS INTELLIGENCE ,Pass,42,16,58,J2EE ,Pass,43,17,60,J2EE AND SOFTWARE TESTING LABORATORY,Pass,70,17,87,PROJECT AND VIVA VOCE ,Pass,225,54,279
M1616211, College : 6222  -  BLDEA S COMMERCE  BHS ARTS & TGP SCIENCE COLLEGE  JAMAKHANDI,DISTI,70.97,SOFTWARE PRACTICES AND TESTING ,Pass,32,17,49,BUSINESS INTELLIGENCE ,Pass,45,17,62,J2EE ,Pass,46,16,62,J2EE AND SOFTWARE TESTING LABORATORY,Pass,68,16,84,PROJECT AND VIVA VOCE ,Pass,220,50,270
M1616213, College : 6222  -  BLDEA S COMMERCE  BHS ARTS & TGP SCIENCE COLLEGE  JAMAKHANDI,DISTI,73.57,SOFTWARE PRACTICES AND TESTING ,Pass,32,16,48,BUSINESS INTELLIGENCE ,Pass,44,15,59,J2EE ,Pass,37,17,54,J2EE AND SOFTWARE TESTING LABORATORY,Pass,70,16,86,PROJECT AND VIVA VOCE ,Pass,225,50,275
M1616214, College : 6222  -  BLDEA S COMMERCE  BHS ARTS & TGP SCIENCE COLLEGE  JAMAKHANDI,DISTI,71.84,SOFTWARE PRACTICES AND TESTING ,Pass,33,18,51,BUSINESS INTELLIGENCE ,Pass,52,18,70,J2EE ,Pass,32,17,49,J2EE AND SOFTWARE TESTING LABORATORY,Pass,70,18,88,PROJECT AND VIVA VOCE ,Pass,225,55,280
M1616401, College : 6239  -  SVSET S SVS BCA COLLEGE  ILKAL,FAIL,79.57,SOFTWARE PRACTICES AND TESTING ,Pass,62,16,78,BUSINESS INTELLIGENCE ,Pass,62,19,81,J2EE ,Fail,23,18,41,J2EE AND SOFTWARE TESTING LABORATORY,Pass,77,20,97,PROJECT AND VIVA VOCE ,Pass,200,60,260
M1616402, College : 6239  -  SVSET S SVS BCA COLLEGE  ILKAL,2ND C,58.32,SOFTWARE PRACTICES AND TESTING ,Pass,38,9,47,BUSINESS INTELLIGENCE ,Pass,54,12,66,J2EE ,Pass,34,10,44,J2EE AND SOFTWARE TESTING LABORATORY,Pass,69,14,83,PROJECT AND VIVA VOCE ,Pass,150,40,190
M1616403, College : 6239  -  SVSET S SVS BCA COLLEGE  ILKAL,DISTI,70.3,SOFTWARE PRACTICES AND TESTING ,Pass,62,16,78,BUSINESS INTELLIGENCE ,Pass,53,19,72,J2EE ,Pass,32,18,50,J2EE AND SOFTWARE TESTING LABORATORY,Pass,50,20,70,PROJECT AND VIVA VOCE ,Pass,200,60,260
M1616404, College : 6239  -  SVSET S SVS BCA COLLEGE  ILKAL,DISTI,81.92,SOFTWARE PRACTICES AND TESTING ,Pass,61,19,80,BUSINESS INTELLIGENCE ,Pass,63,19,82,J2EE ,Pass,34,15,49,J2EE AND SOFTWARE TESTING LABORATORY,Pass,70,17,87,PROJECT AND VIVA VOCE ,Pass,223,55,278
M1616406, College : 6239  -  SVSET S SVS BCA COLLEGE  ILKAL,1ST C,68.89,SOFTWARE PRACTICES AND TESTING ,Pass,62,16,78,BUSINESS INTELLIGENCE ,Pass,64,20,84,J2EE ,Pass,35,18,53,J2EE AND SOFTWARE TESTING LABORATORY,Pass,68,20,88,PROJECT AND VIVA VOCE ,Pass,200,55,255
M1616407, College : 6239  -  SVSET S SVS BCA COLLEGE  ILKAL,DISTI,71.73,SOFTWARE PRACTICES AND TESTING ,Pass,63,16,79,BUSINESS INTELLIGENCE ,Pass,55,20,75,J2EE ,Pass,32,18,50,J2EE AND SOFTWARE TESTING LABORATORY,Pass,50,20,70,PROJECT AND VIVA VOCE ,Pass,225,60,285
M1616409, College : 6239  -  SVSET S SVS BCA COLLEGE  ILKAL,DISTI,76.73,SOFTWARE PRACTICES AND TESTING ,Pass,61,18,79,BUSINESS INTELLIGENCE ,Pass,48,20,68,J2EE ,Pass,33,18,51,J2EE AND SOFTWARE TESTING LABORATORY,Pass,64,20,84,PROJECT AND VIVA VOCE ,Pass,220,60,280
M1616410, College : 6239  -  SVSET S SVS BCA COLLEGE  ILKAL,DISTI,86.89,SOFTWARE PRACTICES AND TESTING ,Pass,72,20,92,BUSINESS INTELLIGENCE ,Pass,68,20,88,J2EE ,Pass,43,18,61,J2EE AND SOFTWARE TESTING LABORATORY,Pass,77,20,97,PROJECT AND VIVA VOCE ,Pass,130,60,190
M1616411, College : 6239  -  SVSET S SVS BCA COLLEGE  ILKAL,FAIL,70.86,SOFTWARE PRACTICES AND TESTING ,Pass,48,17,65,BUSINESS INTELLIGENCE ,Pass,40,19,59,J2EE ,Fail,23,19,42,J2EE AND SOFTWARE TESTING LABORATORY,Pass,60,20,80,PROJECT AND VIVA VOCE ,Pass,190,60,250
M1616412, College : 6239  -  SVSET S SVS BCA COLLEGE  ILKAL,FAIL,67.57,SOFTWARE PRACTICES AND TESTING ,Pass,39,18,57,BUSINESS INTELLIGENCE ,Pass,42,18,60,J2EE ,Fail,13,18,31,J2EE AND SOFTWARE TESTING LABORATORY,Pass,50,20,70,PROJECT AND VIVA VOCE ,Pass,200,55,255
M1616413, College : 6239  -  SVSET S SVS BCA COLLEGE  ILKAL,FAIL,70.86,SOFTWARE PRACTICES AND TESTING ,Pass,46,19,65,BUSINESS INTELLIGENCE ,Pass,32,18,50,J2EE ,Fail,17,18,35,J2EE AND SOFTWARE TESTING LABORATORY,Pass,76,20,96,PROJECT AND VIVA VOCE ,Pass,200,50,250
M1616414, College : 6239  -  SVSET S SVS BCA COLLEGE  ILKAL,DISTI,85.41,SOFTWARE PRACTICES AND TESTING ,Pass,55,20,75,BUSINESS INTELLIGENCE ,Pass,57,20,77,J2EE ,Pass,54,20,74,J2EE AND SOFTWARE TESTING LABORATORY,Pass,77,20,97,PROJECT AND VIVA VOCE ,Pass,220,60,280
M1616415, College : 6239  -  SVSET S SVS BCA COLLEGE  ILKAL,DISTI,83.22,SOFTWARE PRACTICES AND TESTING ,Pass,65,20,85,BUSINESS INTELLIGENCE ,Pass,69,20,89,J2EE ,Pass,54,20,74,J2EE AND SOFTWARE TESTING LABORATORY,Pass,76,20,96,PROJECT AND VIVA VOCE ,Pass,220,60,280
M1616416, College : 6239  -  SVSET S SVS BCA COLLEGE  ILKAL,DISTI,82.46,SOFTWARE PRACTICES AND TESTING ,Pass,58,19,77,BUSINESS INTELLIGENCE ,Pass,48,20,68,J2EE ,Pass,42,19,61,J2EE AND SOFTWARE TESTING LABORATORY,Pass,74,20,94,PROJECT AND VIVA VOCE ,Pass,210,60,270
M1616418, College : 6239  -  SVSET S SVS BCA COLLEGE  ILKAL,DISTI,73.08,SOFTWARE PRACTICES AND TESTING ,Pass,61,19,80,BUSINESS INTELLIGENCE ,Pass,50,20,70,J2EE ,Pass,32,20,52,J2EE AND SOFTWARE TESTING LABORATORY,Pass,74,20,94,PROJECT AND VIVA VOCE ,Pass,220,60,280
M1616419, College : 6239  -  SVSET S SVS BCA COLLEGE  ILKAL,DISTI,76.22,SOFTWARE PRACTICES AND TESTING ,Pass,51,19,70,BUSINESS INTELLIGENCE ,Pass,71,20,91,J2EE ,Pass,36,20,56,J2EE AND SOFTWARE TESTING LABORATORY,Pass,72,20,92,PROJECT AND VIVA VOCE ,Pass,200,60,260
M1616420, College : 6239  -  SVSET S SVS BCA COLLEGE  ILKAL,DISTI,80.41,SOFTWARE PRACTICES AND TESTING ,Pass,51,19,70,BUSINESS INTELLIGENCE ,Pass,70,20,90,J2EE ,Pass,35,19,54,J2EE AND SOFTWARE TESTING LABORATORY,Pass,53,20,73,PROJECT AND VIVA VOCE ,Pass,220,60,280
M1616421, College : 6239  -  SVSET S SVS BCA COLLEGE  ILKAL,FAIL,65.29,SOFTWARE PRACTICES AND TESTING ,Pass,50,18,68,BUSINESS INTELLIGENCE ,Pass,52,20,72,J2EE ,Fail,22,18,40,J2EE AND SOFTWARE TESTING LABORATORY,Pass,67,20,87,PROJECT AND VIVA VOCE ,Pass,130,60,190
M1616422, College : 6239  -  SVSET S SVS BCA COLLEGE  ILKAL,FAIL,73,SOFTWARE PRACTICES AND TESTING ,Pass,39,20,59,BUSINESS INTELLIGENCE ,Pass,40,19,59,J2EE ,Fail,23,18,41,J2EE AND SOFTWARE TESTING LABORATORY,Pass,62,20,82,PROJECT AND VIVA VOCE ,Pass,210,60,270
M1616423, College : 6239  -  SVSET S SVS BCA COLLEGE  ILKAL,DISTI,75.03,SOFTWARE PRACTICES AND TESTING ,Pass,56,19,75,BUSINESS INTELLIGENCE ,Pass,56,16,72,J2EE ,Pass,32,19,51,J2EE AND SOFTWARE TESTING LABORATORY,Pass,67,20,87,PROJECT AND VIVA VOCE ,Pass,220,60,280
M1616425, College : 6239  -  SVSET S SVS BCA COLLEGE  ILKAL,DISTI,74.19,SOFTWARE PRACTICES AND TESTING ,Pass,56,19,75,BUSINESS INTELLIGENCE ,Pass,69,20,89,J2EE ,Pass,32,20,52,J2EE AND SOFTWARE TESTING LABORATORY,Pass,62,20,82,PROJECT AND VIVA VOCE ,Pass,220,60,280
M1616426, College : 6239  -  SVSET S SVS BCA COLLEGE  ILKAL,FAIL,79,SOFTWARE PRACTICES AND TESTING ,Pass,44,18,62,BUSINESS INTELLIGENCE ,Pass,66,19,85,J2EE ,Fail,20,19,39,J2EE AND SOFTWARE TESTING LABORATORY,Pass,67,20,87,PROJECT AND VIVA VOCE ,Pass,230,50,280
M1616427, College : 6239  -  SVSET S SVS BCA COLLEGE  ILKAL,DISTI,78.86,SOFTWARE PRACTICES AND TESTING ,Pass,54,20,74,BUSINESS INTELLIGENCE ,Pass,56,18,74,J2EE ,Pass,42,19,61,J2EE AND SOFTWARE TESTING LABORATORY,Pass,68,20,88,PROJECT AND VIVA VOCE ,Pass,220,60,280
M1616428, College : 6239  -  SVSET S SVS BCA COLLEGE  ILKAL,FAIL,78.43,SOFTWARE PRACTICES AND TESTING ,Pass,45,19,64,BUSINESS INTELLIGENCE ,Pass,59,20,79,J2EE ,Fail,20,19,39,J2EE AND SOFTWARE TESTING LABORATORY,Pass,67,20,87,PROJECT AND VIVA VOCE ,Pass,220,60,280
M1616429, College : 6239  -  SVSET S SVS BCA COLLEGE  ILKAL,DISTI,72.62,SOFTWARE PRACTICES AND TESTING ,Pass,56,20,76,BUSINESS INTELLIGENCE ,Pass,63,20,83,J2EE ,Pass,32,20,52,J2EE AND SOFTWARE TESTING LABORATORY,Pass,72,20,92,PROJECT AND VIVA VOCE ,Pass,210,58,268
M1616430, College : 6239  -  SVSET S SVS BCA COLLEGE  ILKAL,DISTI,77.92,SOFTWARE PRACTICES AND TESTING ,Pass,61,19,80,BUSINESS INTELLIGENCE ,Pass,68,20,88,J2EE ,Pass,38,19,57,J2EE AND SOFTWARE TESTING LABORATORY,Pass,47,20,67,PROJECT AND VIVA VOCE ,Pass,210,60,270
M1616431, College : 6239  -  SVSET S SVS BCA COLLEGE  ILKAL,DISTI,79.35,SOFTWARE PRACTICES AND TESTING ,Pass,53,20,73,BUSINESS INTELLIGENCE ,Pass,73,20,93,J2EE ,Pass,38,20,58,J2EE AND SOFTWARE TESTING LABORATORY,Pass,78,20,98,PROJECT AND VIVA VOCE ,Pass,210,60,270
M1616432, College : 6239  -  SVSET S SVS BCA COLLEGE  ILKAL,FAIL,66.71,SOFTWARE PRACTICES AND TESTING ,Pass,37,15,52,BUSINESS INTELLIGENCE ,Pass,61,18,79,J2EE ,Fail,16,18,34,J2EE AND SOFTWARE TESTING LABORATORY,Pass,62,20,82,PROJECT AND VIVA VOCE ,Pass,170,50,220
M1616433, College : 6239  -  SVSET S SVS BCA COLLEGE  ILKAL,FAIL,63.43,SOFTWARE PRACTICES AND TESTING ,Pass,32,19,51,BUSINESS INTELLIGENCE ,Pass,51,19,70,J2EE ,Fail,17,19,36,J2EE AND SOFTWARE TESTING LABORATORY,Pass,57,20,77,PROJECT AND VIVA VOCE ,Pass,150,60,210
M1616434, College : 6239  -  SVSET S SVS BCA COLLEGE  ILKAL,FAIL,73.14,SOFTWARE PRACTICES AND TESTING ,Pass,32,19,51,BUSINESS INTELLIGENCE ,Pass,53,16,69,J2EE ,Fail,22,18,40,J2EE AND SOFTWARE TESTING LABORATORY,Pass,72,20,92,PROJECT AND VIVA VOCE ,Pass,200,60,260
M1616435, College : 6239  -  SVSET S SVS BCA COLLEGE  ILKAL,DISTI,77,SOFTWARE PRACTICES AND TESTING ,Pass,40,19,59,BUSINESS INTELLIGENCE ,Pass,64,20,84,J2EE ,Pass,43,20,63,J2EE AND SOFTWARE TESTING LABORATORY,Pass,74,20,94,PROJECT AND VIVA VOCE ,Pass,225,60,285
M1616436, College : 6239  -  SVSET S SVS BCA COLLEGE  ILKAL,N.C.L,--   ,SOFTWARE PRACTICES AND TESTING ,Pass,42,19,61,BUSINESS INTELLIGENCE ,Pass,32,19,51,J2EE ,Pass,32,20,52,J2EE AND SOFTWARE TESTING LABORATORY,Pass,52,20,72,PROJECT AND VIVA VOCE ,Pass,225,60,285
M1616437, College : 6239  -  SVSET S SVS BCA COLLEGE  ILKAL,DISTI,78.76,SOFTWARE PRACTICES AND TESTING ,Pass,46,19,65,BUSINESS INTELLIGENCE ,Pass,54,20,74,J2EE ,Pass,46,20,66,J2EE AND SOFTWARE TESTING LABORATORY,Pass,73,20,93,PROJECT AND VIVA VOCE ,Pass,130,60,190
M1616438, College : 6239  -  SVSET S SVS BCA COLLEGE  ILKAL,N.C.L,--   ,SOFTWARE PRACTICES AND TESTING ,Pass,62,18,80,BUSINESS INTELLIGENCE ,Pass,43,20,63,J2EE ,Pass,32,18,50,J2EE AND SOFTWARE TESTING LABORATORY,Pass,72,20,92,PROJECT AND VIVA VOCE ,Pass,130,60,190
M1616439, College : 6239  -  SVSET S SVS BCA COLLEGE  ILKAL,DISTI,76.03,SOFTWARE PRACTICES AND TESTING ,Pass,48,19,67,BUSINESS INTELLIGENCE ,Pass,51,20,71,J2EE ,Pass,39,20,59,J2EE AND SOFTWARE TESTING LABORATORY,Pass,72,20,92,PROJECT AND VIVA VOCE ,Pass,220,60,280
M1616440, College : 6239  -  SVSET S SVS BCA COLLEGE  ILKAL,DISTI,73.73,SOFTWARE PRACTICES AND TESTING ,Pass,50,18,68,BUSINESS INTELLIGENCE ,Pass,61,16,77,J2EE ,Pass,39,18,57,J2EE AND SOFTWARE TESTING LABORATORY,Pass,72,20,92,PROJECT AND VIVA VOCE ,Pass,238,58,296
M1616441, College : 6239  -  SVSET S SVS BCA COLLEGE  ILKAL,DISTI,80.59,SOFTWARE PRACTICES AND TESTING ,Pass,62,20,82,BUSINESS INTELLIGENCE ,Pass,67,20,87,J2EE ,Pass,53,20,73,J2EE AND SOFTWARE TESTING LABORATORY,Pass,78,20,98,PROJECT AND VIVA VOCE ,Pass,220,60,280
M1616442, College : 6239  -  SVSET S SVS BCA COLLEGE  ILKAL,DISTI,83.65,SOFTWARE PRACTICES AND TESTING ,Pass,61,19,80,BUSINESS INTELLIGENCE ,Pass,57,20,77,J2EE ,Pass,41,20,61,J2EE AND SOFTWARE TESTING LABORATORY,Pass,73,20,93,PROJECT AND VIVA VOCE ,Pass,220,60,280
M1616443, College : 6239  -  SVSET S SVS BCA COLLEGE  ILKAL,FAIL,67.14,SOFTWARE PRACTICES AND TESTING ,Pass,32,17,49,BUSINESS INTELLIGENCE ,Pass,47,19,66,J2EE ,Fail,13,19,32,J2EE AND SOFTWARE TESTING LABORATORY,Pass,58,20,78,PROJECT AND VIVA VOCE ,Pass,190,55,245
M1616444, College : 6239  -  SVSET S SVS BCA COLLEGE  ILKAL,FAIL,62.71,SOFTWARE PRACTICES AND TESTING ,Pass,42,15,57,BUSINESS INTELLIGENCE ,Pass,49,17,66,J2EE ,Fail,21,18,39,J2EE AND SOFTWARE TESTING LABORATORY,Pass,57,20,77,PROJECT AND VIVA VOCE ,Pass,150,50,200
M1616445, College : 6239  -  SVSET S SVS BCA COLLEGE  ILKAL,DISTI,82.41,SOFTWARE PRACTICES AND TESTING ,Pass,55,19,74,BUSINESS INTELLIGENCE ,Pass,70,20,90,J2EE ,Pass,41,20,61,J2EE AND SOFTWARE TESTING LABORATORY,Pass,74,20,94,PROJECT AND VIVA VOCE ,Pass,220,60,280
M1616446, College : 6239  -  SVSET S SVS BCA COLLEGE  ILKAL,DISTI,79.65,SOFTWARE PRACTICES AND TESTING ,Pass,62,19,81,BUSINESS INTELLIGENCE ,Pass,70,20,90,J2EE ,Pass,41,20,61,J2EE AND SOFTWARE TESTING LABORATORY,Pass,72,20,92,PROJECT AND VIVA VOCE ,Pass,190,60,250
M1616447, College : 6239  -  SVSET S SVS BCA COLLEGE  ILKAL,FAIL,66.29,SOFTWARE PRACTICES AND TESTING ,Pass,43,19,62,BUSINESS INTELLIGENCE ,Pass,47,20,67,J2EE ,Fail,13,20,33,J2EE AND SOFTWARE TESTING LABORATORY,Pass,62,20,82,PROJECT AND VIVA VOCE ,Pass,160,60,220
M1616448, College : 6239  -  SVSET S SVS BCA COLLEGE  ILKAL,N.C.L,--   ,SOFTWARE PRACTICES AND TESTING ,Pass,47,19,66,BUSINESS INTELLIGENCE ,Pass,59,19,78,J2EE ,Pass,34,20,54,J2EE AND SOFTWARE TESTING LABORATORY,Pass,67,20,87,PROJECT AND VIVA VOCE ,Pass,200,60,260
M1616449, College : 6239  -  SVSET S SVS BCA COLLEGE  ILKAL,N.C.L,--   ,SOFTWARE PRACTICES AND TESTING ,Pass,45,18,63,BUSINESS INTELLIGENCE ,Pass,54,18,72,J2EE ,Pass,37,19,56,J2EE AND SOFTWARE TESTING LABORATORY,Pass,67,20,87,PROJECT AND VIVA VOCE ,Pass,220,60,280
M1616450, College : 6239  -  SVSET S SVS BCA COLLEGE  ILKAL,DISTI,77.54,SOFTWARE PRACTICES AND TESTING ,Pass,57,18,75,BUSINESS INTELLIGENCE ,Pass,60,20,80,J2EE ,Pass,54,19,73,J2EE AND SOFTWARE TESTING LABORATORY,Pass,72,20,92,PROJECT AND VIVA VOCE ,Pass,225,58,283
M1616451, College : 6239  -  SVSET S SVS BCA COLLEGE  ILKAL,N.C.L,--   ,SOFTWARE PRACTICES AND TESTING ,Pass,53,18,71,BUSINESS INTELLIGENCE ,Pass,53,16,69,J2EE ,Pass,32,19,51,J2EE AND SOFTWARE TESTING LABORATORY,Pass,57,20,77,PROJECT AND VIVA VOCE ,Pass,210,60,270
M1616452, College : 6239  -  SVSET S SVS BCA COLLEGE  ILKAL,N.C.L,--   ,SOFTWARE PRACTICES AND TESTING ,Pass,54,18,72,BUSINESS INTELLIGENCE ,Pass,64,20,84,J2EE ,Pass,32,19,51,J2EE AND SOFTWARE TESTING LABORATORY,Pass,59,20,79,PROJECT AND VIVA VOCE ,Pass,130,60,190
M1616453, College : 6239  -  SVSET S SVS BCA COLLEGE  ILKAL,N.C.L,--   ,SOFTWARE PRACTICES AND TESTING ,Pass,59,20,79,BUSINESS INTELLIGENCE ,Pass,75,20,95,J2EE ,Pass,45,20,65,J2EE AND SOFTWARE TESTING LABORATORY,Pass,76,20,96,PROJECT AND VIVA VOCE ,Pass,200,60,260
M1616454, College : 6239  -  SVSET S SVS BCA COLLEGE  ILKAL,DISTI,77.51,SOFTWARE PRACTICES AND TESTING ,Pass,62,18,80,BUSINESS INTELLIGENCE ,Pass,63,20,83,J2EE ,Pass,42,18,60,J2EE AND SOFTWARE TESTING LABORATORY,Pass,67,20,87,PROJECT AND VIVA VOCE ,Pass,170,60,230
M1616455, College : 6239  -  SVSET S SVS BCA COLLEGE  ILKAL,DISTI,84.54,SOFTWARE PRACTICES AND TESTING ,Pass,65,19,84,BUSINESS INTELLIGENCE ,Pass,74,20,94,J2EE ,Pass,52,20,72,J2EE AND SOFTWARE TESTING LABORATORY,Pass,72,20,92,PROJECT AND VIVA VOCE ,Pass,220,60,280
M1616457, College : 6239  -  SVSET S SVS BCA COLLEGE  ILKAL,DISTI,80.78,SOFTWARE PRACTICES AND TESTING ,Pass,58,18,76,BUSINESS INTELLIGENCE ,Pass,71,20,91,J2EE ,Pass,39,20,59,J2EE AND SOFTWARE TESTING LABORATORY,Pass,69,20,89,PROJECT AND VIVA VOCE ,Pass,234,60,294
M1616458, College : 6239  -  SVSET S SVS BCA COLLEGE  ILKAL,DISTI,90.35,SOFTWARE PRACTICES AND TESTING ,Pass,70,20,90,BUSINESS INTELLIGENCE ,Pass,72,20,92,J2EE ,Pass,64,20,84,J2EE AND SOFTWARE TESTING LABORATORY,Pass,78,20,98,PROJECT AND VIVA VOCE ,Pass,220,60,280
M1616459, College : 6239  -  SVSET S SVS BCA COLLEGE  ILKAL,DISTI,70.24,SOFTWARE PRACTICES AND TESTING ,Pass,58,16,74,BUSINESS INTELLIGENCE ,Pass,63,16,79,J2EE ,Pass,32,17,49,J2EE AND SOFTWARE TESTING LABORATORY,Pass,57,20,77,PROJECT AND VIVA VOCE ,Pass,130,40,170
M1616601, College : 6240  -  BVVS S S R KANTHI BCA COLLEGE  MUDHOL,DISTI,76.41,SOFTWARE PRACTICES AND TESTING ,Pass,60,19,79,BUSINESS INTELLIGENCE ,Pass,47,19,66,J2EE ,Pass,32,19,51,J2EE AND SOFTWARE TESTING LABORATORY,Pass,79,20,99,PROJECT AND VIVA VOCE ,Pass,235,59,294
M1616602, College : 6240  -  BVVS S S R KANTHI BCA COLLEGE  MUDHOL,DISTI,82.51,SOFTWARE PRACTICES AND TESTING ,Pass,50,20,70,BUSINESS INTELLIGENCE ,Pass,49,19,68,J2EE ,Pass,40,19,59,J2EE AND SOFTWARE TESTING LABORATORY,Pass,79,20,99,PROJECT AND VIVA VOCE ,Pass,240,59,299
M1616604, College : 6240  -  BVVS S S R KANTHI BCA COLLEGE  MUDHOL,DISTI,73.95,SOFTWARE PRACTICES AND TESTING ,Pass,58,18,76,BUSINESS INTELLIGENCE ,Pass,48,18,66,J2EE ,Pass,32,18,50,J2EE AND SOFTWARE TESTING LABORATORY,Pass,78,19,97,PROJECT AND VIVA VOCE ,Pass,230,56,286
M1616605, College : 6240  -  BVVS S S R KANTHI BCA COLLEGE  MUDHOL,N.C.L,--   ,SOFTWARE PRACTICES AND TESTING ,Pass,32,17,49,BUSINESS INTELLIGENCE ,Pass,45,15,60,J2EE ,Pass,34,16,50,J2EE AND SOFTWARE TESTING LABORATORY,Pass,74,16,90,PROJECT AND VIVA VOCE ,Pass,210,52,262
M1616606, College : 6240  -  BVVS S S R KANTHI BCA COLLEGE  MUDHOL,FAIL,67.43,SOFTWARE PRACTICES AND TESTING ,Pass,50,13,63,BUSINESS INTELLIGENCE ,Pass,45,13,58,J2EE ,Fail,21,12,33,J2EE AND SOFTWARE TESTING LABORATORY,Pass,69,14,83,PROJECT AND VIVA VOCE ,Pass,190,45,235
M1616607, College : 6240  -  BVVS S S R KANTHI BCA COLLEGE  MUDHOL,DISTI,79.68,SOFTWARE PRACTICES AND TESTING ,Pass,64,18,82,BUSINESS INTELLIGENCE ,Pass,61,19,80,J2EE ,Pass,33,19,52,J2EE AND SOFTWARE TESTING LABORATORY,Pass,78,19,97,PROJECT AND VIVA VOCE ,Pass,232,58,290
M1616608, College : 6240  -  BVVS S S R KANTHI BCA COLLEGE  MUDHOL,DISTI,92.38,SOFTWARE PRACTICES AND TESTING ,Pass,73,20,93,BUSINESS INTELLIGENCE ,Pass,75,20,95,J2EE ,Pass,55,20,75,J2EE AND SOFTWARE TESTING LABORATORY,Pass,80,20,100,PROJECT AND VIVA VOCE ,Pass,240,60,300
M1616609, College : 6240  -  BVVS S S R KANTHI BCA COLLEGE  MUDHOL,DISTI,90.03,SOFTWARE PRACTICES AND TESTING ,Pass,70,20,90,BUSINESS INTELLIGENCE ,Pass,72,20,92,J2EE ,Pass,55,20,75,J2EE AND SOFTWARE TESTING LABORATORY,Pass,80,20,100,PROJECT AND VIVA VOCE ,Pass,240,60,300
M1616610, College : 6240  -  BVVS S S R KANTHI BCA COLLEGE  MUDHOL,DISTI,89.59,SOFTWARE PRACTICES AND TESTING ,Pass,62,20,82,BUSINESS INTELLIGENCE ,Pass,67,20,87,J2EE ,Pass,70,20,90,J2EE AND SOFTWARE TESTING LABORATORY,Pass,80,20,100,PROJECT AND VIVA VOCE ,Pass,240,60,300
M1616611, College : 6240  -  BVVS S S R KANTHI BCA COLLEGE  MUDHOL,DISTI,82.86,SOFTWARE PRACTICES AND TESTING ,Pass,54,20,74,BUSINESS INTELLIGENCE ,Pass,56,19,75,J2EE ,Pass,62,19,81,J2EE AND SOFTWARE TESTING LABORATORY,Pass,80,20,100,PROJECT AND VIVA VOCE ,Pass,235,60,295
M1616612, College : 6240  -  BVVS S S R KANTHI BCA COLLEGE  MUDHOL,N.C.L,--   ,SOFTWARE PRACTICES AND TESTING ,Pass,58,18,76,BUSINESS INTELLIGENCE ,Pass,53,19,72,J2EE ,Pass,41,18,59,J2EE AND SOFTWARE TESTING LABORATORY,Pass,78,18,96,PROJECT AND VIVA VOCE ,Pass,230,57,287
M1616613, College : 6240  -  BVVS S S R KANTHI BCA COLLEGE  MUDHOL,DISTI,80.68,SOFTWARE PRACTICES AND TESTING ,Pass,45,20,65,BUSINESS INTELLIGENCE ,Pass,67,19,86,J2EE ,Pass,46,18,64,J2EE AND SOFTWARE TESTING LABORATORY,Pass,79,19,98,PROJECT AND VIVA VOCE ,Pass,230,58,288
M1616615, College : 6240  -  BVVS S S R KANTHI BCA COLLEGE  MUDHOL,FAIL,80.57,SOFTWARE PRACTICES AND TESTING ,Pass,51,19,70,BUSINESS INTELLIGENCE ,Pass,58,19,77,J2EE ,Fail,22,18,40,J2EE AND SOFTWARE TESTING LABORATORY,Pass,72,18,90,PROJECT AND VIVA VOCE ,Pass,230,57,287
M1616617, College : 6240  -  BVVS S S R KANTHI BCA COLLEGE  MUDHOL,DISTI,82.68,SOFTWARE PRACTICES AND TESTING ,Pass,56,19,75,BUSINESS INTELLIGENCE ,Pass,68,19,87,J2EE ,Pass,47,17,64,J2EE AND SOFTWARE TESTING LABORATORY,Pass,75,17,92,PROJECT AND VIVA VOCE ,Pass,230,57,287
M1616618, College : 6240  -  BVVS S S R KANTHI BCA COLLEGE  MUDHOL,DISTI,78.89,SOFTWARE PRACTICES AND TESTING ,Pass,50,20,70,BUSINESS INTELLIGENCE ,Pass,68,19,87,J2EE ,Pass,38,18,56,J2EE AND SOFTWARE TESTING LABORATORY,Pass,72,18,90,PROJECT AND VIVA VOCE ,Pass,228,58,286
M1616619, College : 6240  -  BVVS S S R KANTHI BCA COLLEGE  MUDHOL,DISTI,83.24,SOFTWARE PRACTICES AND TESTING ,Pass,50,20,70,BUSINESS INTELLIGENCE ,Pass,70,19,89,J2EE ,Pass,45,19,64,J2EE AND SOFTWARE TESTING LABORATORY,Pass,79,19,98,PROJECT AND VIVA VOCE ,Pass,235,59,294
M1616620, College : 6240  -  BVVS S S R KANTHI BCA COLLEGE  MUDHOL,DISTI,74.62,SOFTWARE PRACTICES AND TESTING ,Pass,47,19,66,BUSINESS INTELLIGENCE ,Pass,62,19,81,J2EE ,Pass,44,18,62,J2EE AND SOFTWARE TESTING LABORATORY,Pass,78,18,96,PROJECT AND VIVA VOCE ,Pass,225,57,282
M1616621, College : 6240  -  BVVS S S R KANTHI BCA COLLEGE  MUDHOL,DISTI,85.19,SOFTWARE PRACTICES AND TESTING ,Pass,60,20,80,BUSINESS INTELLIGENCE ,Pass,73,19,92,J2EE ,Pass,45,19,64,J2EE AND SOFTWARE TESTING LABORATORY,Pass,80,20,100,PROJECT AND VIVA VOCE ,Pass,235,60,295
M1616622, College : 6240  -  BVVS S S R KANTHI BCA COLLEGE  MUDHOL,DISTI,89.3,SOFTWARE PRACTICES AND TESTING ,Pass,57,20,77,BUSINESS INTELLIGENCE ,Pass,64,20,84,J2EE ,Pass,50,20,70,J2EE AND SOFTWARE TESTING LABORATORY,Pass,80,20,100,PROJECT AND VIVA VOCE ,Pass,240,60,300
M1616623, College : 6240  -  BVVS S S R KANTHI BCA COLLEGE  MUDHOL,DISTI,78.51,SOFTWARE PRACTICES AND TESTING ,Pass,42,18,60,BUSINESS INTELLIGENCE ,Pass,56,19,75,J2EE ,Pass,38,18,56,J2EE AND SOFTWARE TESTING LABORATORY,Pass,72,18,90,PROJECT AND VIVA VOCE ,Pass,230,56,286
M1616624, College : 6240  -  BVVS S S R KANTHI BCA COLLEGE  MUDHOL,1ST C,69.68,SOFTWARE PRACTICES AND TESTING ,Pass,38,15,53,BUSINESS INTELLIGENCE ,Pass,48,17,65,J2EE ,Pass,32,14,46,J2EE AND SOFTWARE TESTING LABORATORY,Pass,62,13,75,PROJECT AND VIVA VOCE ,Pass,190,46,236
M1616625, College : 6240  -  BVVS S S R KANTHI BCA COLLEGE  MUDHOL,DISTI,79.59,SOFTWARE PRACTICES AND TESTING ,Pass,50,19,69,BUSINESS INTELLIGENCE ,Pass,68,20,88,J2EE ,Pass,33,18,51,J2EE AND SOFTWARE TESTING LABORATORY,Pass,79,18,97,PROJECT AND VIVA VOCE ,Pass,225,56,281
M1616626, College : 6240  -  BVVS S S R KANTHI BCA COLLEGE  MUDHOL,DISTI,79.76,SOFTWARE PRACTICES AND TESTING ,Pass,50,20,70,BUSINESS INTELLIGENCE ,Pass,66,19,85,J2EE ,Pass,40,19,59,J2EE AND SOFTWARE TESTING LABORATORY,Pass,79,19,98,PROJECT AND VIVA VOCE ,Pass,230,58,288
M1616627, College : 6240  -  BVVS S S R KANTHI BCA COLLEGE  MUDHOL,N.C.L,--   ,SOFTWARE PRACTICES AND TESTING ,Pass,51,19,70,BUSINESS INTELLIGENCE ,Pass,68,18,86,J2EE ,Pass,40,17,57,J2EE AND SOFTWARE TESTING LABORATORY,Pass,77,18,95,PROJECT AND VIVA VOCE ,Pass,230,56,286
M1616629, College : 6240  -  BVVS S S R KANTHI BCA COLLEGE  MUDHOL,N.C.L,--   ,SOFTWARE PRACTICES AND TESTING ,Pass,37,12,49,BUSINESS INTELLIGENCE ,Pass,55,10,65,J2EE ,Pass,37,12,49,J2EE AND SOFTWARE TESTING LABORATORY,Pass,60,12,72,PROJECT AND VIVA VOCE ,Pass,170,40,210
M1616630, College : 6240  -  BVVS S S R KANTHI BCA COLLEGE  MUDHOL,FAIL,73.57,SOFTWARE PRACTICES AND TESTING ,Fail,19,17,36,BUSINESS INTELLIGENCE ,Pass,51,17,68,J2EE ,Fail,22,17,39,J2EE AND SOFTWARE TESTING LABORATORY,Pass,75,17,92,PROJECT AND VIVA VOCE ,Pass,225,55,280
M1616631, College : 6240  -  BVVS S S R KANTHI BCA COLLEGE  MUDHOL,DISTI,83.41,SOFTWARE PRACTICES AND TESTING ,Pass,65,20,85,BUSINESS INTELLIGENCE ,Pass,67,19,86,J2EE ,Pass,42,20,62,J2EE AND SOFTWARE TESTING LABORATORY,Pass,80,19,99,PROJECT AND VIVA VOCE ,Pass,239,60,299
M1616632, College : 6240  -  BVVS S S R KANTHI BCA COLLEGE  MUDHOL,DISTI,87.38,SOFTWARE PRACTICES AND TESTING ,Pass,67,20,87,BUSINESS INTELLIGENCE ,Pass,77,20,97,J2EE ,Pass,48,20,68,J2EE AND SOFTWARE TESTING LABORATORY,Pass,80,20,100,PROJECT AND VIVA VOCE ,Pass,239,60,299
M1616633, College : 6240  -  BVVS S S R KANTHI BCA COLLEGE  MUDHOL,1ST C,67.05,SOFTWARE PRACTICES AND TESTING ,Pass,44,15,59,BUSINESS INTELLIGENCE ,Pass,57,15,72,J2EE ,Pass,32,13,45,J2EE AND SOFTWARE TESTING LABORATORY,Pass,62,17,79,PROJECT AND VIVA VOCE ,Pass,180,40,220
M1616634, College : 6240  -  BVVS S S R KANTHI BCA COLLEGE  MUDHOL,DISTI,84.76,SOFTWARE PRACTICES AND TESTING ,Pass,63,20,83,BUSINESS INTELLIGENCE ,Pass,72,20,92,J2EE ,Pass,36,20,56,J2EE AND SOFTWARE TESTING LABORATORY,Pass,79,20,99,PROJECT AND VIVA VOCE ,Pass,235,60,295
M1616635, College : 6240  -  BVVS S S R KANTHI BCA COLLEGE  MUDHOL,DISTI,94.32,SOFTWARE PRACTICES AND TESTING ,Pass,77,20,97,BUSINESS INTELLIGENCE ,Pass,79,20,99,J2EE ,Pass,65,20,85,J2EE AND SOFTWARE TESTING LABORATORY,Pass,80,20,100,PROJECT AND VIVA VOCE ,Pass,240,60,300
M1616636, College : 6240  -  BVVS S S R KANTHI BCA COLLEGE  MUDHOL,DISTI,75.81,SOFTWARE PRACTICES AND TESTING ,Pass,60,17,77,BUSINESS INTELLIGENCE ,Pass,63,18,81,J2EE ,Pass,33,18,51,J2EE AND SOFTWARE TESTING LABORATORY,Pass,70,18,88,PROJECT AND VIVA VOCE ,Pass,230,57,287
M1616637, College : 6240  -  BVVS S S R KANTHI BCA COLLEGE  MUDHOL,DISTI,77.57,SOFTWARE PRACTICES AND TESTING ,Pass,61,18,79,BUSINESS INTELLIGENCE ,Pass,67,19,86,J2EE ,Pass,36,18,54,J2EE AND SOFTWARE TESTING LABORATORY,Pass,72,19,91,PROJECT AND VIVA VOCE ,Pass,225,57,282
